movie,year,production_budget,domestic_gross,foreign_gross,worldwide_gross,profit,profit_margin,roi,release_date,rating_average,rating_count,genre_list
Avatar,2009,425000000,760507625,2015837654,2776345279,2351345279,0.846921057,5.532577127058824,12/18/09,7.4,18676,"['Action', 'Adventure', 'Fantasy', 'Science Fiction']"
Pirates of the Caribbean: On Stranger Tides,2011,410600000,241063875,804600000,1045663875,635063875,0.6073307973845802,1.5466728567949342,5/20/11,6.4,8571,"['Adventure', 'Action', 'Fantasy']"
Avengers: Age of Ultron,2015,330600000,459005868,944008095,1403013963,1072413963,0.7643644263574588,3.2438413883847548,5/1/15,7.3,13457,"['Action', 'Adventure', 'Science Fiction']"
Avengers: Infinity War,2018,300000000,678815482,1369318718,2048134200,1748134200,0.8535252231030565,5.827114,4/27/18,8.3,13948,"['Adventure', 'Action', 'Fantasy']"
Justice League,2017,300000000,229024295,426920914,655945209,355945209,0.5426447272061713,1.18648403,11/17/17,6.2,7510,"['Action', 'Adventure', 'Fantasy', 'Science Fiction']"
Justice League,2017,300000000,229024295,426920914,655945209,355945209,0.5426447272061713,1.18648403,11/17/17,6.2,7510,"['Action', 'Adventure', 'Fantasy', 'Science Fiction']"
Spectre,2015,300000000,200074175,679546748,879620923,579620923,0.6589439926271513,1.9320697433333334,11/6/15,6.4,6719,"['Action', 'Adventure', 'Crime']"
Spectre,2015,300000000,200074175,679546748,879620923,579620923,0.6589439926271513,1.9320697433333334,11/6/15,6.4,6719,"['Action', 'Adventure', 'Crime']"
The Dark Knight Rises,2012,275000000,448139099,636300000,1084439099,809439099,0.7464126844434258,2.9434149054545453,7/20/12,7.7,13933,"['Action', 'Crime', 'Drama', 'Thriller']"
Solo: A Star Wars Story,2018,275000000,213767512,179383835,393151347,118151347,0.3005238260063751,0.4296412618181818,5/25/18,6.6,3838,"['Action', 'Adventure', 'Science Fiction']"
The Lone Ranger,2013,275000000,89302115,170700000,260002115,-14997885,-0.057683704,-0.054537764,7/3/13,6,3789,"['Action', 'Adventure', 'Western']"
John Carter,2012,275000000,73058679,209719421,282778100,7778100,0.027506019737737822,0.028284,3/9/12,6.1,3338,"['Action', 'Adventure', 'Science Fiction']"
Tangled,2010,260000000,200821936,385655304,586477240,326477240,0.5566750382333677,1.2556816923076923,11/24/10,7.5,6407,"['Animation', 'Family']"
Captain America: Civil War,2016,250000000,408084349,731985064,1140069413,890069413,0.7807151063353719,3.560277652,5/6/16,7.4,14000,"['Adventure', 'Action', 'Science Fiction']"
Batman v Superman: Dawn of Justice,2016,250000000,330360194,537140087,867500281,617500281,0.7118156553081277,2.470001124,3/25/16,5.8,11991,"['Action', 'Adventure', 'Fantasy']"
The Hobbit: An Unexpected Journey,2012,250000000,303003568,714000000,1017003568,767003568,0.7541798201439545,3.068014272,12/14/12,7.2,12076,"['Adventure', 'Fantasy', 'Action']"
The Hobbit: The Desolation of Smaug,2013,250000000,258366855,702000000,960366855,710366855,0.7396828111065953,2.84146742,12/13/13,7.6,7739,"['Adventure', 'Fantasy', 'Action']"
The Hobbit: The Battle of the Five Armies,2014,250000000,255119788,690457833,945577621,695577621,0.7356113401503609,2.782310484,12/17/14,7.3,8392,"['Action', 'Adventure', 'Fantasy']"
The Fate of the Furious,2017,250000000,225764765,1009081502,1234846267,984846267,0.7975456486519872,3.939385068,4/14/17,6.9,6335,"['Action', 'Crime', 'Thriller']"
Pirates of the Caribbean: Dead Men Tell No Tales,2017,230000000,172558876,615682261,788241137,558241137,0.7082111181416303,2.4271353782608696,5/26/17,6.6,6931,"['Adventure', 'Action', 'Fantasy', 'Comedy']"
The Avengers,2012,225000000,623279547,894656350,1517935897,1292935897,0.851772397,5.746381764444444,5/4/12,7.6,19673,"['Science Fiction', 'Action', 'Adventure']"
Man of Steel,2013,225000000,291045518,376954000,667999518,442999518,0.6631734096550651,1.9688867466666666,6/14/13,6.5,9758,"['Action', 'Adventure', 'Fantasy', 'Science Fiction']"
The Amazing Spider-Man,2012,220000000,262030663,495859604,757890267,537890267,0.7097205102384565,2.444955759090909,7/4/12,6.5,10411,"['Action', 'Adventure', 'Fantasy']"
Battleship,2012,220000000,65233400,248244317,313477717,93477717,0.2981957310860472,0.4248987136363636,5/18/12,5.6,3240,"['Thriller', 'Action', 'Adventure', 'Science Fiction']"
Transformers: The Last Knight,2017,217000000,130168683,472724657,602893340,385893340,0.6400690045771612,1.7783103225806451,6/21/17,6,3255,"['Action', 'Science Fiction', 'Thriller', 'Adventure']"
Jurassic World,2015,215000000,652270625,996584239,1648854864,1433854864,0.8696064737447989,6.669092390697674,6/12/15,6.6,14056,"['Action', 'Adventure', 'Science Fiction', 'Thriller']"
Men in Black 3,2012,215000000,179020854,475192631,654213485,439213485,0.6713611001155074,2.042853418604651,5/25/12,6.4,6398,"['Action', 'Comedy', 'Science Fiction']"
Transformers: Age of Extinction,2014,210000000,245439076,858600000,1104039076,894039076,0.8097893411881374,4.2573289333333335,6/27/14,5.8,4805,"['Science Fiction', 'Action', 'Adventure']"
Robin Hood,2010,210000000,105487148,216971858,322459006,112459006,0.3487544274077431,0.5355190761904762,5/14/10,6.3,2569,"['Action', 'Adventure', 'Drama']"
Black Panther,2018,200000000,700059566,648198658,1348258224,1148258224,0.8516604635226018,5.74129112,2/16/18,7.4,12365,"['Action', 'Adventure', 'Fantasy', 'Science Fiction']"
Incredibles 2,2018,200000000,608581744,633938967,1242520711,1042520711,0.8390368882953775,5.212603555,6/15/18,7.6,6354,"['Action', 'Adventure', 'Animation', 'Family']"
Rogue One: A Star Wars Story,2016,200000000,532177324,516925532,1049102856,849102856,0.8093609231390749,4.24551428,12/16/16,7.5,9296,"['Action', 'Adventure', 'Science Fiction']"
Rogue One: A Star Wars Story,2016,200000000,532177324,516925532,1049102856,849102856,0.8093609231390749,4.24551428,12/16/16,7.5,9296,"['Action', 'Adventure', 'Science Fiction']"
Finding Dory,2016,200000000,486295561,534919632,1021215193,821215193,0.8041548917692218,4.106075965,6/17/16,7,7845,"['Adventure', 'Animation', 'Comedy', 'Family']"
Toy Story 3,2010,200000000,415004880,653874642,1068879522,868879522,0.812888173,4.34439761,6/17/10,7.7,8340,"['Animation', 'Family', 'Comedy']"
Iron Man 3,2013,200000000,408992272,806400000,1215392272,1015392272,0.8354440746353536,5.07696136,5/3/13,6.9,14155,"['Action', 'Adventure', 'Science Fiction']"
Alice in Wonderland,2010,200000000,334191110,691300000,1025491110,825491110,0.8049714931219638,4.12745555,3/5/10,6.6,8713,"['Family', 'Fantasy', 'Adventure']"
Alice in Wonderland,2010,200000000,334191110,691300000,1025491110,825491110,0.8049714931219638,4.12745555,1/1/10,6,1,[None]
Skyfall,2012,200000000,304360277,806166704,1110526981,910526981,0.8199053211477083,4.552634905,11/9/12,7.1,10441,"['Action', 'Adventure', 'Thriller']"
Monsters University,2013,200000000,268488329,475100000,743588329,543588329,0.7310339710832121,2.717941645,6/21/13,7,6362,"['Animation', 'Family']"
Oz the Great and Powerful,2013,200000000,234770996,255588055,490359051,290359051,0.5921356002461143,1.451795255,3/8/13,5.8,4829,"['Fantasy', 'Adventure', 'Family']"
X-Men: Days of Future Past,2014,200000000,233921534,513941241,747862775,547862775,0.7325712594800563,2.739313875,5/23/14,7.5,10062,"['Action', 'Adventure', 'Fantasy', 'Science Fiction']"
The Amazing Spider-Man 2,2014,200000000,202853933,506142403,708996336,508996336,0.7179110951004971,2.54498168,5/2/14,6.4,7220,"['Action', 'Adventure', 'Fantasy']"
Cars 2,2011,200000000,191450875,368704508,560155383,360155383,0.6429562116695753,1.800776915,6/16/11,5.9,4058,"['Animation', 'Family', 'Adventure', 'Comedy']"
Fantastic Beasts: The Crimes of Grindelwald,2018,200000000,159555901,492664185,652220086,452220086,0.6933550433465184,2.26110043,11/16/18,6.9,4870,['Adventure']
Green Lantern,2011,200000000,116601172,102934320,219535492,19535492,0.088985575,0.09767746,6/17/11,5.1,4290,"['Adventure', 'Action', 'Thriller', 'Science Fiction']"
Transformers: Dark of the Moon,2011,195000000,352390543,771400000,1123790543,928790543,0.8264801201481546,4.763028425641026,6/28/11,6.1,4961,"['Action', 'Science Fiction', 'Adventure']"
The Mummy,2017,195000000,80101125,329852780,409953905,214953905,0.5243367665933076,1.1023277179487179,6/9/17,5.5,4391,"['Fantasy', 'Thriller', 'Action', 'Adventure', 'Horror']"
Jack the Giant Slayer,2013,195000000,65187603,132500000,197687603,2687603,0.013595202527697197,0.013782579487179487,3/1/13,5.6,3403,"['Action', 'Adventure', 'Family', 'Fantasy']"
Furious 7,2015,190000000,353007020,1165715774,1518722794,1328722794,0.874894878,6.9932778631578945,4/3/15,7.3,6538,"['Action', 'Crime', 'Thriller']"
Star Trek Into Darkness,2013,190000000,228778661,238602923,467381584,277381584,0.5934799176854174,1.4599030736842105,5/16/13,7.4,6182,"['Action', 'Adventure', 'Science Fiction']"
World War Z,2013,190000000,202359711,329154939,531514650,341514650,0.6425310196059506,1.7974455263157896,6/21/13,6.7,9132,"['Action', 'Drama', 'Horror', 'Science Fiction', 'Thriller']"
The Great Gatsby,2013,190000000,144840419,206200000,351040419,161040419,0.45875178550308193,0.847581153,5/10/13,7.4,7120,"['Drama', 'Romance']"
Pacific Rim,2013,190000000,101802906,309200000,411002906,221002906,0.5377161639825486,1.1631731894736843,7/12/13,6.8,7632,"['Action', 'Science Fiction', 'Adventure']"
The Good Dinosaur,2015,187500000,123087120,210683917,333771037,146271037,0.43823765631288136,0.7801121973333334,11/25/15,6.7,3135,"['Adventure', 'Animation', 'Family']"
The Good Dinosaur,2015,187500000,123087120,210683917,333771037,146271037,0.43823765631288136,0.7801121973333334,11/25/15,6.7,3135,"['Adventure', 'Animation', 'Family']"
Brave,2012,185000000,237282182,317324350,554606532,369606532,0.6664301818933499,1.997873145945946,6/22/12,6.9,8116,"['Animation', 'Adventure', 'Comedy', 'Family', 'Action', 'Fantasy']"
Kong: Skull Island,2017,185000000,168052812,393019247,561072059,376072059,0.6702740814972574,2.0328219405405403,3/10/17,6.3,6054,"['Action', 'Adventure', 'Fantasy']"
Star Trek Beyond,2016,185000000,158848340,176953893,335802233,150802233,0.4490804949471554,0.8151472054054054,7/22/16,6.7,4275,"['Action', 'Adventure', 'Science Fiction']"
Blade Runner 2049,2017,185000000,92054159,167303249,259357408,74357408,0.2866986085857243,0.40193193513513514,10/6/17,7.4,6679,"['Science Fiction', 'Action', 'Thriller']"
Blade Runner 2049,2017,185000000,92054159,167303249,259357408,74357408,0.2866986085857243,0.40193193513513514,10/6/17,7.4,6679,"['Science Fiction', 'Action', 'Thriller']"
Thor: Ragnarok,2017,180000000,315058289,531921735,846980024,666980024,0.7874802298761181,3.7054445777777776,11/3/17,7.5,11380,"['Action', 'Adventure', 'Comedy', 'Fantasy']"
Thor: Ragnarok,2017,180000000,315058289,531921735,846980024,666980024,0.7874802298761181,3.7054445777777776,11/3/17,7.5,11380,"['Action', 'Adventure', 'Comedy', 'Fantasy']"
Maleficent,2014,180000000,241407328,517129407,758536735,578536735,0.7627010114414564,3.2140929722222222,5/30/14,7,8143,"['Fantasy', 'Adventure', 'Action', 'Family', 'Romance']"
Fantastic Beasts and Where to Find Them,2016,180000000,234037575,568365278,802402853,622402853,0.7756737786673846,3.457793627777778,11/18/16,7.4,12152,"['Adventure', 'Family', 'Fantasy']"
Fantastic Beasts and Where to Find Them,2016,180000000,234037575,568365278,802402853,622402853,0.7756737786673846,3.457793627777778,11/18/16,7.4,12152,"['Adventure', 'Family', 'Fantasy']"
The Legend of Tarzan,2016,180000000,126643061,222258964,348902025,168902025,0.4840958575691844,0.9383445833333334,7/1/16,5.8,4102,"['Action', 'Adventure']"
Hugo,2011,180000000,73864507,106183277,180047784,47784,0.000265396,0.000265467,11/23/11,7.1,4124,"['Adventure', 'Drama', 'Family']"
Valerian and the City of a Thousand Planets,2017,180000000,40479370,174618986,215098356,35098356,0.16317352048938952,0.19499086666666668,7/21/17,6.6,4149,"['Adventure', 'Science Fiction', 'Action']"
Jupiter Ascending,2015,179000000,47482519,134500000,181982519,2982519,0.016389041191368497,0.016662117318435754,2/27/15,5.3,4401,"['Science Fiction', 'Fantasy', 'Action', 'Adventure']"
X-Men: Apocalypse,2016,178000000,155442489,387095057,542537546,364537546,0.6719121076276627,2.047963741573034,5/27/16,6.5,8348,"['Action', 'Adventure', 'Science Fiction', 'Fantasy']"
The Meg,2018,178000000,145443742,384086973,529530715,351530715,0.6638533045245544,1.9748916573033708,8/10/18,5.9,2896,"['Action', 'Science Fiction', 'Thriller', 'Horror']"
Edge of Tomorrow,2014,178000000,100206256,270335000,370541256,192541256,0.5196216423468916,1.0816924494382023,6/6/14,7.6,8047,"['Action', 'Science Fiction']"
The Jungle Book,2016,175000000,364001123,598853424,962854547,787854547,0.818248768,4.502025982857143,4/15/16,6.8,5257,"['Adventure', 'Drama', 'Family', 'Fantasy']"
Inside Out,2015,175000000,356461711,497774281,854235992,679235992,0.7951385780523282,3.881348525714286,6/19/15,8,12691,"['Drama', 'Comedy', 'Animation', 'Family']"
Spider-Man: Homecoming,2017,175000000,334201140,545965210,880166350,705166350,0.8011739485382507,4.029522,7/7/17,7.4,11585,"['Action', 'Adventure', 'Science Fiction', 'Drama']"
Suicide Squad,2016,175000000,325100054,420959833,746059887,571059887,0.7654343799347035,3.2631993542857143,8/5/16,5.9,13533,"['Action', 'Adventure', 'Crime', 'Fantasy', 'Science Fiction']"
Coco,2017,175000000,209726015,588282086,798008101,623008101,0.780703981,3.5600462914285713,11/22/17,8.2,8669,"['Animation', 'Family', 'Comedy', 'Adventure', 'Fantasy']"
Coco,2017,175000000,209726015,588282086,798008101,623008101,0.780703981,3.5600462914285713,11/22/17,8.2,8669,"['Animation', 'Family', 'Comedy', 'Adventure', 'Fantasy']"
Cars 3,2017,175000000,152901115,230640254,383541369,208541369,0.5437258816271264,1.1916649657142857,6/16/17,6.7,2596,"['Adventure', 'Animation', 'Comedy', 'Family']"
King Arthur: Legend of the Sword,2017,175000000,39175066,100455270,139630336,-35369664,-0.25330931,-0.202112366,5/12/17,6.5,3305,"['Action', 'Drama', 'Fantasy']"
47 Ronin,2013,175000000,38362475,113354340,151716815,-23283185,-0.153464763,-0.133046771,12/25/13,6,2080,"['Drama', 'Action', 'Adventure', 'Fantasy']"
Jurassic World: Fallen Kingdom,2018,170000000,417719760,888053039,1305772799,1135772799,0.869808898,6.681016464705882,6/22/18,6.5,5995,"['Action', 'Adventure', 'Science Fiction']"
Guardians of the Galaxy,2014,170000000,333172112,437695404,770867516,600867516,0.7794692389139407,3.5345148,8/1/14,7.9,17958,"['Action', 'Science Fiction', 'Adventure']"
Iron Man 2,2010,170000000,312433331,308723058,621156389,451156389,0.7263169098627753,2.653861111764706,5/7/10,6.8,12368,"['Adventure', 'Action', 'Science Fiction']"
Captain America: The Winter Soldier,2014,170000000,259746958,454654931,714401889,544401889,0.7620387031199466,3.2023640529411765,4/4/14,7.7,11034,"['Action', 'Adventure', 'Science Fiction']"
Dawn of the Planet of the Apes,2014,170000000,208545589,502098977,710644566,540644566,0.7607805531295655,3.1802621529411765,7/11/14,7.3,7080,"['Science Fiction', 'Action', 'Drama', 'Thriller']"
Snow White and the Huntsman,2012,170000000,155136755,245884991,401021746,231021746,0.5760828391585527,1.3589514470588235,6/1/12,5.9,5258,"['Adventure', 'Fantasy', 'Drama']"
Van Helsing,2004,170000000,120150546,180000000,300150546,130150546,0.4336175553716967,0.7655914470588235,5/7/04,6.1,3047,"['Horror', 'Adventure', 'Action']"
Tomorrowland,2015,170000000,93436322,113191196,206627518,36627518,0.17726350466059415,0.2154559882352941,5/22/15,6.2,4610,"['Adventure', 'Family', 'Mystery', 'Science Fiction']"
Alice Through the Looking Glass,2016,170000000,77042381,199885731,276928112,106928112,0.3861222727723648,0.628988894,5/27/16,6.5,3803,"['Adventure', 'Family', 'Fantasy']"
Shrek Forever After,2010,165000000,238736787,517507886,756244673,591244673,0.7818166449418414,3.5833010484848486,5/16/10,6.1,3843,"['Comedy', 'Adventure', 'Fantasy', 'Animation', 'Family']"
Doctor Strange,2016,165000000,232641920,443762646,676404566,511404566,0.7560631487517191,3.099421612121212,11/4/16,7.3,12582,"['Action', 'Adventure', 'Fantasy', 'Science Fiction']"
Doctor Strange,2016,165000000,232641920,443762646,676404566,511404566,0.7560631487517191,3.099421612121212,11/4/16,7.3,12582,"['Action', 'Adventure', 'Fantasy', 'Science Fiction']"
Big Hero 6,2014,165000000,222527828,429600000,652127828,487127828,0.7469821208120565,2.952289866666667,11/7/14,7.8,10176,"['Adventure', 'Family', 'Animation', 'Action', 'Comedy']"
Big Hero 6,2014,165000000,222527828,429600000,652127828,487127828,0.7469821208120565,2.952289866666667,11/7/14,7.8,10176,"['Adventure', 'Family', 'Animation', 'Action', 'Comedy']"
How to Train Your Dragon,2010,165000000,217581232,277289760,494870992,329870992,0.6665797699453759,1.9992181333333334,3/26/10,7.7,7610,"['Fantasy', 'Adventure', 'Animation', 'Family']"
Wreck-It Ralph,2012,165000000,189412677,307098844,496511521,331511521,0.6676814272754811,2.0091607333333332,11/2/12,7.3,7780,"['Family', 'Animation', 'Comedy', 'Adventure']"
Interstellar,2014,165000000,188017894,478361481,666379375,501379375,0.7523932969864201,3.038662878787879,11/5/14,8.2,18597,"['Adventure', 'Drama', 'Science Fiction']"
Independence Day: Resurgence,2016,165000000,103144286,281025138,384169424,219169424,0.5705019980975894,1.3282995393939394,6/24/16,5.1,3911,"['Action', 'Adventure', 'Science Fiction']"
Beauty and the Beast,2017,160000000,504014165,755185541,1259199706,1099199706,0.8729351672831474,6.869998163,3/17/17,6.9,11023,"['Family', 'Fantasy', 'Romance']"
Aquaman,2018,160000000,335061807,811832833,1146894640,986894640,0.8604928522466545,6.1680915,12/21/18,6.8,6155,"['Action', 'Adventure', 'Fantasy']"
Inception,2010,160000000,292576195,542948447,835524642,675524642,0.8085035533877168,4.222029013,7/16/10,8.3,22186,"['Action', 'Science Fiction', 'Adventure']"
The Hunger Games: Mockingjay - Part 2,2015,160000000,281723902,367262885,648986787,488986787,0.753461853,3.056167419,11/18/15,6.8,7609,"['Action', 'Adventure', 'Science Fiction']"
The Hunger Games: Mockingjay - Part 2,2015,160000000,281723902,367262885,648986787,488986787,0.753461853,3.056167419,11/18/15,6.8,7609,"['Action', 'Adventure', 'Science Fiction']"
Godzilla,2014,160000000,200676069,328400000,529076069,369076069,0.6975860195256725,2.306725431,5/16/14,6.1,5053,"['Action', 'Drama', 'Science Fiction']"
X-Men: First Class,2011,160000000,146408305,209000000,355408305,195408305,0.5498135588024596,1.221301906,6/3/11,7.2,8211,"['Action', 'Science Fiction', 'Adventure']"
The Sorcerer's Apprentice,2010,160000000,63150991,154835329,217986320,57986320,0.2660089862519813,0.3624145,7/13/10,5.9,2879,"['Fantasy', 'Adventure', 'Action', 'Comedy', 'Drama']"
Warcraft,2016,160000000,47225655,378296626,425522281,265522281,0.6239914872988754,1.659514256,6/10/16,6.3,4071,"['Action', 'Adventure', 'Fantasy']"
Deepwater Horizon,2016,156000000,61433527,61170297,122603824,-33396176,-0.272390982,-0.214078051,9/30/16,6.7,2606,"['Drama', 'Action']"
Deepwater Horizon,2016,156000000,61433527,61170297,122603824,-33396176,-0.272390982,-0.214078051,9/30/16,6.7,2606,"['Drama', 'Action']"
The Chronicles of Narnia: The Voyage of the Dawn Treader,2010,155000000,104386950,313800000,418186950,263186950,0.629352375,1.6979803225806451,12/10/10,6.3,3196,"['Adventure', 'Family', 'Fantasy']"
Pacific Rim: Uprising,2018,155000000,59874525,231055623,290930148,135930148,0.46722606417537726,0.8769686967741935,3/23/18,5.9,2213,"['Action', 'Fantasy', 'Science Fiction', 'Adventure']"
War for the Planet of the Apes,2017,152000000,146880162,342712105,489592267,337592267,0.6895375800533222,2.2210017565789473,7/14/17,7,5235,"['Drama', 'Science Fiction', 'War']"
Wonder Woman,2017,150000000,412563408,408569970,821133378,671133378,0.8173256574159138,4.47422252,6/2/17,7.3,12566,"['Adventure', 'Fantasy', 'War', 'Romance']"
Frozen,2013,150000000,400738009,871731901,1272469910,1122469910,0.8821190200088896,7.483132733333333,11/27/13,7.3,9767,"['Animation', 'Adventure', 'Family']"
Zootopia,2016,150000000,341268248,678161368,1019429616,869429616,0.8528588951647643,5.79619744,3/4/16,7.7,9977,"['Animation', 'Adventure', 'Family', 'Comedy']"
Moana,2016,150000000,248757044,388760321,637517365,487517365,0.7647122914055839,3.2501157666666667,11/23/16,7.5,6907,"['Adventure', 'Comedy', 'Family', 'Animation']"
Moana,2016,150000000,248757044,388760321,637517365,487517365,0.7647122914055839,3.2501157666666667,11/23/16,7.5,6907,"['Adventure', 'Comedy', 'Family', 'Animation']"
Thor: The Dark World,2013,150000000,206362140,438240376,644602516,494602516,0.7672984571471949,3.297350106666667,11/8/13,6.7,10171,"['Action', 'Adventure', 'Fantasy']"
Dunkirk,2017,150000000,190068280,309769088,499837368,349837368,0.6999023890506721,2.33224912,7/19/17,7.4,9156,"['War', 'Action', 'Drama']"
Thor,2011,150000000,181030624,268295994,449326618,299326618,0.6661671176578281,1.9955107866666666,5/6/11,6.7,12764,"['Adventure', 'Fantasy', 'Action']"
Kung Fu Panda 2,2011,150000000,165249063,499588484,664837547,514837547,0.7743809737027383,3.4322503133333333,5/25/11,6.7,3628,"['Animation', 'Family']"
Mad Max: Fury Road,2015,150000000,153636354,216461666,370098020,220098020,0.5947019657116782,1.4673201333333334,5/15/15,7.4,14454,"['Action', 'Adventure', 'Science Fiction']"
Ready Player One,2018,150000000,137690172,441599964,579290136,429290136,0.7410623957180587,2.86193424,3/29/18,7.6,7021,"['Adventure', 'Science Fiction']"
The Last Airbender,2010,150000000,131772187,187941694,319713881,169713881,0.5308305052916986,1.1314258733333333,7/1/10,4.6,2143,"['Action', 'Adventure', 'Family', 'Fantasy']"
Wrath of the Titans,2012,150000000,83670083,221600000,305270083,155270083,0.5086318366808319,1.0351338866666666,3/29/12,5.6,2442,"['Fantasy', 'Adventure', 'Action']"
Dark Shadows,2012,150000000,79727149,158475519,238202668,88202668,0.3702841313263544,0.5880177866666667,5/11/12,5.9,4197,"['Comedy', 'Fantasy']"
White House Down,2013,150000000,73103784,132336603,205440387,55440387,0.269861188,0.36960258,6/28/13,6.4,2817,"['Action', 'Drama', 'Thriller']"
The Wolfman,2010,150000000,62189884,80444474,142634358,-7365642,-0.051640026,-0.04910428,2/12/10,5.7,1009,['Horror']
The Great Wall,2017,150000000,45157105,289329747,334486852,184486852,0.5515518798329329,1.2299123466666666,2/17/17,5.8,2775,"['Action', 'Adventure', 'Fantasy']"
Pan,2015,150000000,35088320,116437653,151525973,1525973,0.010070702532297878,0.010173153333333334,10/9/15,5.9,1701,"['Adventure', 'Family', 'Fantasy']"
Mars Needs Moms,2011,150000000,21392758,18157000,39549758,-110450242,-2.792690716,-0.736334947,3/11/11,5.7,299,"['Adventure', 'Animation', 'Family']"
Madagascar 3: Europe's Most Wanted,2012,145000000,216391482,530529789,746921271,601921271,0.8058697674978921,4.151181179310345,6/8/12,6.5,3380,"['Animation', 'Family', 'Comedy']"
How to Train Your Dragon 2,2014,145000000,177002924,437583346,614586270,469586270,0.7640689239608298,3.238526,6/13/14,7.7,5589,"['Fantasy', 'Action', 'Adventure', 'Animation', 'Comedy', 'Family']"
Mr. Peabody & Sherman,2014,145000000,111506430,158300000,269806430,124806430,0.4625776709621042,0.860734,3/7/14,6.6,1357,"['Animation', 'Adventure', 'Family']"
Rise of the Guardians,2012,145000000,103412758,203488144,306900902,161900902,0.5275347871085762,1.1165579448275862,11/21/12,7.3,3697,"['Animation', 'Family', 'Fantasy']"
Ghostbusters,2016,144000000,128350574,100658084,229008658,85008658,0.37120281277749767,0.5903379027777778,7/15/16,5.4,3780,"['Action', 'Fantasy', 'Comedy']"
Armageddon,1998,140000000,201578182,353021818,554600000,414600000,0.7475658131987017,2.9614285714285713,7/1/98,6.7,4267,"['Action', 'Thriller', 'Science Fiction', 'Adventure']"
Captain America: The First Avenger,2011,140000000,176654505,193915271,370569776,230569776,0.6222034038739306,1.6469269714285715,7/22/11,6.9,12810,"['Action', 'Adventure', 'Science Fiction']"
Kung Fu Panda 3,2016,140000000,143528619,374070523,517599142,377599142,0.7295204171725617,2.6971367285714285,1/29/16,6.7,2944,"['Action', 'Adventure', 'Animation', 'Comedy', 'Family']"
G.I. Joe: Retaliation,2013,140000000,122523060,253217645,375740705,235740705,0.627402626,1.6838621785714285,3/29/13,5.5,3883,"['Adventure', 'Action', 'Science Fiction', 'Thriller']"
Exodus: Gods and Kings,2014,140000000,65014513,203300000,268314513,128314513,0.4782242733176345,0.9165322357142857,12/12/14,5.7,2909,"['Adventure', 'Drama', 'Action']"
The BFG,2016,140000000,55483770,144162910,199646680,59646680,0.2987611915209409,0.4260477142857143,7/1/16,6.2,1916,"['Adventure', 'Family', 'Fantasy']"
Gods of Egypt,2016,140000000,31153464,107683292,138836756,-1163244,-0.008378502,-0.008308886,2/26/16,5.4,2353,"['Action', 'Adventure', 'Fantasy', 'Science Fiction']"
The Croods,2013,135000000,187168425,385900000,573068425,438068425,0.7644260369082453,3.2449512962962963,3/22/13,6.8,3873,"['Action', 'Adventure', 'Animation', 'Comedy', 'Family', 'Fantasy']"
The Revenant,2015,135000000,183637894,349300408,532938302,397938302,0.7466873754553299,2.947691125925926,12/25/15,7.4,11064,"['Western', 'Drama', 'Adventure']"
The Revenant,2015,135000000,183637894,349300408,532938302,397938302,0.7466873754553299,2.947691125925926,12/25/15,7.4,11064,"['Western', 'Drama', 'Adventure']"
Rango,2011,135000000,123477607,122246993,245724600,110724600,0.4506044571849949,0.8201822222222223,3/3/11,6.6,3412,"['Animation', 'Comedy', 'Family', 'Western', 'Adventure']"
Turbo,2013,135000000,83028130,203868448,286896578,151896578,0.5294471584809213,1.125159837037037,7/19/13,6.1,1758,"['Animation', 'Family']"
Teenage Mutant Ninja Turtles: Out of the Shadows,2016,135000000,82051601,163276773,245328374,110328374,0.44971713708093136,0.8172472148148148,6/3/16,5.9,1860,"['Action', 'Adventure', 'Comedy', 'Family', 'Science Fiction']"
Happy Feet Two,2011,135000000,64006466,93950000,157956466,22956466,0.14533413276035184,0.1700478962962963,11/17/11,5.9,754,"['Animation', 'Comedy', 'Family']"
The Nutcracker and the Four Realms,2018,132900000,54858851,115435048,170293899,37393899,0.21958449022298795,0.281368691,11/2/18,6,909,"['Fantasy', 'Adventure', 'Family']"
Penguins of Madagascar,2014,132000000,83350911,283591620,366942531,234942531,0.6402706449964504,1.779867659090909,11/26/14,6.4,2273,"['Family', 'Animation', 'Adventure', 'Comedy']"
The Hunger Games: Catching Fire,2013,130000000,424668047,440200000,864868047,734868047,0.8496880530493226,5.652831130769231,11/22/13,7.4,11170,"['Adventure', 'Action', 'Science Fiction']"
The Bourne Ultimatum,2007,130000000,227471070,216572326,444043396,314043396,0.7072358216087511,2.415718430769231,8/3/07,7.4,4440,"['Action', 'Drama', 'Mystery', 'Thriller']"
Ant-Man and the Wasp,2018,130000000,216648740,406495920,623144660,493144660,0.7913807044418867,3.7934204615384615,7/6/18,7,6290,"['Action', 'Adventure', 'Science Fiction', 'Comedy']"
Ant-Man,2015,130000000,180202163,338656286,518858449,388858449,0.7494499699281181,2.9912188384615384,7/17/15,7.1,11949,"['Science Fiction', 'Action', 'Adventure']"
Home,2015,130000000,177397510,208600386,385997896,255997896,0.6632105994691743,1.9692145846153846,3/27/15,6.8,2372,"['Fantasy', 'Comedy', 'Animation', 'Science Fiction', 'Family']"
Mary Poppins Returns,2018,130000000,171958438,169570080,341528518,211528518,0.619358287,1.6271424461538462,12/19/18,6.6,1457,"['Fantasy', 'Family', 'Comedy']"
Puss in Boots,2011,130000000,149260504,405726973,554987477,424987477,0.7657604803936864,3.2691344384615384,10/28/11,6.3,1422,"['Action', 'Adventure', 'Animation', 'Family', 'Fantasy', 'Comedy']"
Megamind,2010,130000000,148415853,173471355,321887208,191887208,0.5961318226724934,1.4760554461538462,11/4/10,6.8,3635,"['Animation', 'Action', 'Comedy', 'Family', 'Science Fiction']"
Rio 2,2014,130000000,131538435,361307856,492846291,362846291,0.7362260762149065,2.7911253153846154,4/11/14,6.3,1803,"['Adventure', 'Comedy', 'Family', 'Animation']"
Salt,2010,130000000,118311368,172339126,290650494,160650494,0.552727407,1.2357730307692307,7/23/10,6.3,3240,"['Action', 'Mystery', 'Thriller']"
Noah,2014,130000000,101200044,251631021,352831065,222831065,0.6315517172502937,1.7140851153846153,3/28/14,5.6,3955,"['Drama', 'Adventure']"
Noah,2014,130000000,101200044,251631021,352831065,222831065,0.6315517172502937,1.7140851153846153,3/25/14,7.5,2,['Documentary']
The Adventures of Tintin,2011,130000000,77591831,296402120,373993951,243993951,0.6524007951133948,1.8768765461538461,12/20/11,6.8,3251,"['Adventure', 'Animation', 'Mystery']"
After Earth,2013,130000000,60522097,190977568,251499665,121499665,0.48310070313612546,0.9346128076923077,5/31/13,5.1,4154,"['Science Fiction', 'Action', 'Adventure']"
R.I.P.D.,2013,130000000,33618855,45457823,79076678,-50923322,-0.643973967,-0.391717862,7/19/13,5.6,2047,"['Fantasy', 'Action', 'Comedy', 'Crime']"
Logan,2017,127000000,226277068,389184326,615461394,488461394,0.7936507452163604,3.846152708661417,3/3/17,7.8,12330,"['Action', 'Drama', 'Science Fiction']"
Night at the Museum: Secret of the Tomb,2014,127000000,113746621,240010000,353756621,226756621,0.6409961186281231,1.7854852047244094,12/19/14,6.1,3536,"['Adventure', 'Comedy', 'Fantasy', 'Family']"
The Hunger Games: Mockingjay - Part 1,2014,125000000,337135885,429439246,766575131,641575131,0.8369370529449122,5.132601048,11/21/14,6.8,10087,"['Science Fiction', 'Adventure', 'Thriller']"
Fast Five,2011,125000000,210031325,420132129,630163454,505163454,0.8016387665667454,4.041307632,4/28/11,7.2,4294,"['Action', 'Thriller', 'Crime']"
Teenage Mutant Ninja Turtles,2014,125000000,191204754,293800000,485004754,360004754,0.7422705675169526,2.880038032,8/8/14,5.8,4259,"['Science Fiction', 'Action', 'Adventure', 'Fantasy', 'Comedy']"
Sherlock Holmes: A Game of Shadows,2011,125000000,186848418,348815025,535663443,410663443,0.7666445197381148,3.285307544,12/16/11,7.1,6380,"['Adventure', 'Action', 'Crime', 'Mystery']"
The Boss Baby,2017,125000000,175003033,335875729,510878762,385878762,0.7553235536536161,3.087030096,3/31/17,6.4,4314,"['Animation', 'Comedy', 'Family']"
Clash of the Titans,2010,125000000,163214888,330000000,493214888,368214888,0.746560773,2.945719104,4/2/10,5.7,3714,"['Adventure', 'Fantasy', 'Action']"
Trolls,2016,125000000,153707064,190443070,344150134,219150134,0.6367864264728138,1.753201072,11/4/16,6.6,1880,"['Adventure', 'Family', 'Comedy', 'Fantasy', 'Music', 'Animation']"
Trolls,2016,125000000,153707064,190443070,344150134,219150134,0.6367864264728138,1.753201072,11/4/16,6.6,1880,"['Adventure', 'Family', 'Comedy', 'Fantasy', 'Music', 'Animation']"
Prometheus,2012,125000000,126477084,275971181,402448265,277448265,0.6894010712159487,2.21958612,6/8/12,6.4,7384,"['Science Fiction', 'Adventure', 'Mystery']"
The Bourne Legacy,2012,125000000,113203870,167152050,280355920,155355920,0.5541381826358438,1.24284736,8/10/12,6.1,3630,"['Action', 'Thriller']"
Skyscraper,2018,125000000,68420120,235695414,304115534,179115534,0.5889719990429689,1.432924272,7/13/18,6.1,2177,['Action']
Total Recall,2012,125000000,58877969,152978119,211856088,86856088,0.4099768329527542,0.694848704,8/3/12,5.9,3486,"['Action', 'Science Fiction', 'Adventure', 'Thriller']"
Monster Trucks,2017,125000000,33370166,28272632,61642798,-63357202,-1.027811911,-0.506857616,1/13/17,5.9,414,"['Action', 'Comedy', 'Science Fiction']"
Jason Bourne,2016,120000000,162192920,253975396,416168316,296168316,0.711655128,2.4680693,7/29/16,6.1,3611,"['Action', 'Thriller']"
Life of Pi,2012,120000000,124987022,495924981,620912003,500912003,0.8067358990964779,4.174266691666666,11/21/12,7.3,8723,"['Adventure', 'Drama', 'Action']"
Rampage,2018,120000000,101028233,327028047,428056280,308056280,0.7196630312257071,2.5671356666666667,4/13/18,6.2,3176,"['Action', 'Adventure', 'Science Fiction', 'Fantasy']"
Elysium,2013,120000000,93050117,193141974,286192091,166192091,0.5807012011383641,1.3849340916666666,8/9/13,6.4,5406,"['Science Fiction', 'Action', 'Drama', 'Thriller']"
Oblivion,2013,120000000,89107235,198809398,287916633,167916633,0.5832126864306586,1.399305275,4/18/13,6.5,6850,"['Action', 'Science Fiction', 'Adventure', 'Mystery']"
Power Rangers,2017,120000000,85364450,57167102,142531552,22531552,0.15808115244545995,0.18776293333333333,3/24/17,6.2,2667,"['Action', 'Adventure', 'Science Fiction']"
RoboCop,2014,120000000,58607007,184374792,242981799,122981799,0.5061358484715145,1.024848325,2/12/14,5.8,3390,"['Action', 'Science Fiction']"
Fantastic Four,2015,120000000,56117548,111731639,167849187,47849187,0.2850724978489172,0.398743225,8/7/15,4.4,3837,"['Action', 'Adventure', 'Science Fiction']"
Knight and Day,2010,117000000,76423035,182328335,258751370,141751370,0.5478284810627283,1.211550170940171,6/23/10,6,2494,"['Action', 'Comedy']"
Venom,2018,116000000,213511408,640117197,853628605,737628605,0.8641095210252473,6.358867284482758,10/5/18,6.6,6206,"['Science Fiction', 'Action']"
The Wolverine,2013,115000000,132556852,283900000,416456852,301456852,0.7238609487448174,2.6213639304347827,7/25/13,6.3,6176,"['Action', 'Science Fiction', 'Adventure', 'Fantasy']"
Dante's Peak,1997,115000000,67163857,111036143,178200000,63200000,0.3546576879910213,0.5495652173913044,2/7/97,5.9,783,"['Action', 'Adventure', 'Thriller', 'Drama']"
Gulliver's Travels,2010,112000000,42779261,189238587,232017848,120017848,0.5172785155735088,1.0715879285714285,12/25/10,5.1,1282,"['Comedy', 'Adventure', 'Family', 'Fantasy']"
Ferdinand,2017,111000000,84410380,205437550,289847930,178847930,0.6170405633050406,1.6112426126126127,12/15/17,7.1,1425,"['Animation', 'Family', 'Adventure', 'Comedy']"
Ferdinand,2017,111000000,84410380,205437550,289847930,178847930,0.6170405633050406,1.6112426126126127,12/15/17,7.1,1425,"['Animation', 'Family', 'Adventure', 'Comedy']"
Deadpool 2,2018,110000000,324591735,462088822,786680557,676680557,0.8601719604975568,6.151641427272727,5/10/18,7.5,8773,"['Action', 'Comedy', 'Adventure']"
Gravity,2013,110000000,274092705,419605968,693698673,583698673,0.8414297096399376,5.306351572727273,10/4/13,7.2,9586,"['Science Fiction', 'Thriller', 'Drama']"
San Andreas,2015,110000000,155190832,301067707,456258539,346258539,0.7589086217628028,3.1478049,5/29/15,6.1,5125,"['Action', 'Drama', 'Thriller']"
The Smurfs,2011,110000000,142614158,421135165,563749323,453749323,0.8048778144608078,4.124993845454545,7/29/11,5.6,2112,"['Animation', 'Family', 'Adventure', 'Comedy', 'Fantasy']"
300: Rise of an Empire,2014,110000000,106580051,224200000,330780051,220780051,0.6674527388593939,2.0070913727272726,3/7/14,6,3870,"['Action', 'War', 'Fantasy']"
Passengers,2016,110000000,100014699,202224973,302239672,192239672,0.6360504255708694,1.7476333818181817,12/21/16,6.8,7869,"['Drama', 'Romance', 'Science Fiction']"
Passengers,2016,110000000,100014699,202224973,302239672,192239672,0.6360504255708694,1.7476333818181817,12/21/16,6.8,7869,"['Drama', 'Romance', 'Science Fiction']"
The Green Hornet,2011,110000000,98780042,130375461,229155503,119155503,0.5199766160535975,1.0832318454545455,1/13/11,5.5,1897,"['Action', 'Crime', 'Comedy']"
Real Steel,2011,110000000,85463309,178417032,263880341,153880341,0.5831443919499861,1.398912190909091,10/6/11,6.8,4566,"['Action', 'Science Fiction', 'Drama']"
The A-Team,2010,110000000,77222099,100019072,177241171,67241171,0.37937670249312444,0.6112833727272727,6/11/10,6.3,2703,"['Thriller', 'Action', 'Adventure', 'Comedy', 'Crime']"
The Smurfs 2,2013,110000000,71017784,277529739,348547523,238547523,0.6844045854831681,2.1686138454545456,7/31/13,5.7,1200,"['Fantasy', 'Family', 'Comedy', 'Animation']"
Ender's Game,2013,110000000,61737191,66246092,127983283,17983283,0.14051274962215182,0.16348439090909092,11/1/13,6.6,3558,"['Science Fiction', 'Action', 'Adventure']"
Ghost in the Shell,2017,110000000,40563557,127347133,167910690,57910690,0.34488983399448836,0.5264608181818182,3/31/17,6,5128,"['Action', 'Science Fiction', 'Thriller', 'Drama']"
The Martian,2015,108000000,228433663,426837780,655271443,547271443,0.835182807,5.067328175925926,10/2/15,7.7,12172,"['Drama', 'Adventure', 'Science Fiction']"
The Martian,2015,108000000,228433663,426837780,655271443,547271443,0.835182807,5.067328175925926,10/2/15,7.7,12172,"['Drama', 'Adventure', 'Science Fiction']"
Allied,2016,106000000,40098064,79168597,119266661,13266661,0.11123528477082124,0.12515717924528302,11/23/16,6.7,2765,"['Action', 'Drama', 'War', 'Romance', 'Thriller']"
Allied,2016,106000000,40098064,79168597,119266661,13266661,0.11123528477082124,0.12515717924528302,11/23/16,6.7,2765,"['Action', 'Drama', 'War', 'Romance', 'Thriller']"
Ice Age: Collision Course,2016,105000000,64063008,338093674,402156682,297156682,0.7389077324842261,2.830063638095238,7/22/16,5.9,2430,"['Adventure', 'Animation', 'Family', 'Comedy']"
Kingsman: The Golden Circle,2017,104000000,100234838,308568858,408803696,304803696,0.7455991689468483,2.930804769230769,9/22/17,7,5531,"['Action', 'Adventure', 'Comedy']"
A Wrinkle in Time,2018,103000000,100478608,32923274,133401882,30401882,0.2278969497596743,0.29516390291262135,3/9/18,5,1073,"['Adventure', 'Science Fiction', 'Family', 'Fantasy']"
Bumblebee,2018,102000000,127195589,338000000,465195589,363195589,0.7807373878603135,3.560741068627451,12/21/18,6.5,2425,"['Action', 'Adventure', 'Science Fiction']"
Cloud Atlas,2012,102000000,27108272,103564882,130673154,28673154,0.2194265089828627,0.28110935294117645,10/26/12,6.8,4505,"['Drama', 'Science Fiction']"
Terminator 2: Judgment Day,1991,100000000,203464105,311955722,515419827,415419827,0.8059834046702282,4.15419827,7/3/91,7.9,6682,"['Action', 'Thriller', 'Science Fiction']"
Terminator 2: Judgment Day,1991,100000000,203464105,311955722,515419827,415419827,0.8059834046702282,4.15419827,7/3/91,7.9,6682,"['Action', 'Thriller', 'Science Fiction']"
Django Unchained,2012,100000000,162805434,287142889,449948323,349948323,0.7777522553406649,3.49948323,12/25/12,8,15725,"['Drama', 'Western']"
Little Fockers,2010,100000000,148438600,162211974,310650574,210650574,0.6780949131611776,2.10650574,12/21/10,5.6,1883,"['Comedy', 'Romance']"
The Other Guys,2010,100000000,119219978,51716492,170936470,70936470,0.4149873341832787,0.7093647,8/6/10,6.2,2187,"['Action', 'Comedy', 'Crime']"
Lemony Snicket's A Series of Unfortunate Events,2004,100000000,118627117,94328907,212956024,112956024,0.5304194822871036,1.12956024,12/17/04,6.8,2975,"['Adventure', 'Comedy', 'Family']"
The Wolf of Wall Street,2013,100000000,116900694,272969720,389870414,289870414,0.7435045173753554,2.89870414,12/25/13,7.9,12411,"['Crime', 'Drama', 'Comedy']"
Epic,2013,100000000,107518682,155275759,262794441,162794441,0.6194744469499642,1.62794441,5/24/13,6.4,1670,"['Animation', 'Adventure', 'Family', 'Fantasy']"
The Expendables 2,2012,100000000,85028192,226951064,311979256,211979256,0.6794658680768185,2.11979256,8/17/12,6.2,4219,"['Action', 'Adventure', 'Thriller']"
Hercules,2014,100000000,72688614,170700000,243388614,143388614,0.5891344366667868,1.43388614,7/25/14,5.6,2606,"['Action', 'Adventure']"
The Tourist,2010,100000000,67631157,211100212,278731369,178731369,0.641231626,1.78731369,12/10/10,6.1,3133,"['Action', 'Thriller', 'Romance']"
Legend of the Guardians: The Owls of Ga'Hoole,2010,100000000,55675313,84041404,139716717,39716717,0.28426603382041965,0.39716717,9/24/10,6.6,1223,"['Animation', 'Adventure', 'Family', 'Fantasy']"
The Expendables 3,2014,100000000,39322544,170138834,209461378,109461378,0.5225850180361173,1.09461378,8/15/14,6.1,2876,"['Action', 'Adventure', 'Thriller']"
Green Zone,2010,100000000,35497337,62025683,97523020,-2476980,-0.025398926,-0.0247698,3/11/10,6.4,1176,"['War', 'Action', 'Adventure', 'Drama', 'Thriller']"
Geostorm,2017,100000000,33700160,187095849,220796009,120796009,0.547093263,1.20796009,10/20/17,5.8,2246,"['Action', 'Science Fiction', 'Thriller']"
Geostorm,2017,100000000,33700160,187095849,220796009,120796009,0.547093263,1.20796009,10/20/17,5.8,2246,"['Action', 'Science Fiction', 'Thriller']"
Point Break,2015,100000000,28782481,97922110,126704591,26704591,0.21076261553932168,0.26704591,12/25/15,5.6,1260,"['Action', 'Crime', 'Thriller']"
In the Heart of the Sea,2015,100000000,25020758,64672551,89693309,-10306691,-0.114910366,-0.10306691,12/11/15,6.6,2137,"['Thriller', 'Drama', 'Adventure', 'Action', 'History']"
In the Heart of the Sea,2015,100000000,25020758,64672551,89693309,-10306691,-0.114910366,-0.10306691,12/11/15,6.6,2137,"['Thriller', 'Drama', 'Adventure', 'Action', 'History']"
Transcendence,2014,100000000,23022309,80016949,103039258,3039258,0.029496116907208318,0.03039258,4/17/14,6,3491,"['Thriller', 'Science Fiction', 'Drama', 'Mystery']"
Mortal Engines,2018,100000000,15951040,69336377,85287417,-14712583,-0.172505904,-0.14712583,12/14/18,6,1751,"['Adventure', 'Fantasy']"
The Peanuts Movie,2015,99000000,130178411,119913199,250091610,151091610,0.6041450570852817,1.5261778787878788,11/1/15,6.6,894,"['Adventure', 'Comedy', 'Animation', 'Family']"
The Peanuts Movie,2015,99000000,130178411,119913199,250091610,151091610,0.6041450570852817,1.5261778787878788,11/1/15,6.6,894,"['Adventure', 'Comedy', 'Animation', 'Family']"
Robin Hood,2018,99000000,30824628,53922813,84747441,-14252559,-0.168176866,-0.143965242,11/21/18,5.8,1194,"['Adventure', 'Action', 'Thriller']"
Alien: Covenant,2017,97000000,74262031,164259216,238521247,141521247,0.5933276334078532,1.4589819278350515,5/19/17,5.9,4971,"['Horror', 'Science Fiction', 'Thriller']"
Cinderella,2015,95000000,201151353,333400000,534551353,439551353,0.8222808726105685,4.626856347368421,3/13/15,6.7,4517,"['Romance', 'Fantasy', 'Family', 'Drama']"
Ice Age: Continental Drift,2012,95000000,161321843,718443294,879765137,784765137,0.892016635,8.260685653,7/13/12,6.3,4598,"['Animation', 'Comedy', 'Adventure', 'Family']"
Sex and the City 2,2010,95000000,95347692,199333086,294680778,199680778,0.6776172485875547,2.1019029263157893,5/27/10,5.9,809,"['Comedy', 'Drama', 'Romance']"
Percy Jackson & the Olympians: The Lightning Thief,2010,95000000,88768303,134282571,223050874,128050874,0.5740881965788666,1.3479039368421053,2/11/10,6.1,4229,"['Adventure', 'Fantasy', 'Family']"
The Campaign,2012,95000000,86907746,18000000,104907746,9907746,0.094442464,0.10429206315789474,8/10/12,5.7,982,['Comedy']
Unstoppable,2010,95000000,81562942,84157979,165720921,70720921,0.426747091,0.7444307473684211,11/12/10,6.4,1913,"['Action', 'Thriller']"
Ben-Hur,2016,95000000,26410477,65259171,91669648,-3330352,-0.036329931,-0.035056337,8/19/16,5.6,1068,"['Action', 'Adventure', 'Drama']"
Seventh Son,2015,95000000,17725785,91149182,108874967,13874967,0.12743945998165032,0.14605228421052632,2/6/15,5.3,1549,"['Adventure', 'Fantasy']"
Kingsman: The Secret Service,2015,94000000,128261724,276300000,404561724,310561724,0.7676497937802934,3.3038481276595744,2/13/15,7.6,10287,"['Crime', 'Comedy', 'Action', 'Adventure']"
Kingsman: The Secret Service,2015,94000000,128261724,276300000,404561724,310561724,0.7676497937802934,3.3038481276595744,2/13/15,7.6,10287,"['Crime', 'Comedy', 'Action', 'Adventure']"
Rise of the Planet of the Apes,2011,93000000,176760185,294226015,470986200,377986200,0.8025419853065758,4.064367741935484,8/4/11,7.2,7259,"['Thriller', 'Action', 'Drama', 'Science Fiction']"
A Good Day to Die Hard,2013,92000000,67349198,236900000,304249198,212249198,0.6976162941274212,2.3070565,2/14/13,5.2,4437,"['Action', 'Thriller']"
The Secret Life of Walter Mitty,2013,91000000,58236838,129624345,187861183,96861183,0.5155997713481875,1.0644086043956045,12/25/13,7.1,4859,"['Adventure', 'Comedy', 'Drama', 'Fantasy']"
Jumanji: Welcome to the Jungle,2017,90000000,404508916,559987277,964496193,874496193,0.9066870344816385,9.716624366666666,12/20/17,6.7,7213,"['Action', 'Adventure', 'Comedy', 'Fantasy']"
Jumanji: Welcome to the Jungle,2017,90000000,404508916,559987277,964496193,874496193,0.9066870344816385,9.716624366666666,12/20/17,6.7,7213,"['Action', 'Adventure', 'Comedy', 'Fantasy']"
Toy Story 2,1999,90000000,245852179,265506097,511358276,421358276,0.823998155,4.6817586222222225,11/24/99,7.5,7553,"['Animation', 'Comedy', 'Family']"
Toy Story 2,1999,90000000,245852179,265506097,511358276,421358276,0.823998155,4.6817586222222225,11/24/99,7.5,7553,"['Animation', 'Comedy', 'Family']"
Rio,2011,90000000,143619809,343900000,487519809,397519809,0.8153921167129436,4.416886766666667,4/15/11,6.6,3730,"['Animation', 'Adventure', 'Comedy', 'Family']"
The Girl with the Dragon Tattoo,2011,90000000,102515793,136858177,239373970,149373970,0.62401927,1.6597107777777778,12/14/11,7.3,3971,"['Thriller', 'Crime', 'Mystery', 'Drama']"
The Magnificent Seven,2016,90000000,93432655,69092501,162525156,72525156,0.4462395716759072,0.8058350666666667,9/23/16,6.2,3647,"['Adventure', 'Action', 'Western']"
Alvin and the Chipmunks: The Road Chip,2015,90000000,85886987,163630969,249517956,159517956,0.6393045156237173,1.7724217333333334,12/18/15,5.8,852,"['Adventure', 'Animation', 'Comedy', 'Family']"
Pixels,2015,90000000,78765986,165275818,244041804,154041804,0.6312107248641712,1.7115756,7/24/15,5.6,4423,"['Action', 'Comedy', 'Science Fiction']"
Percy Jackson: Sea of Monsters,2013,90000000,68559554,132300000,200859554,110859554,0.5519257201975067,1.2317728222222222,8/7/13,5.9,3109,"['Adventure', 'Family', 'Fantasy']"
Now You See Me 2,2016,90000000,65075540,263249467,328325007,238325007,0.7258813733917014,2.648055633333333,6/10/16,6.8,6744,"['Action', 'Comedy', 'Thriller']"
Tomb Raider,2018,90000000,58250803,215226698,273477501,183477501,0.6709052859160066,2.0386389,3/16/18,6.3,4310,"['Action', 'Adventure', 'Fantasy']"
Conan the Barbarian,2011,90000000,21295021,42061112,63356133,-26643867,-0.420541244,-0.296042967,8/19/11,5.2,1024,"['Adventure', 'Fantasy', 'Action']"
The Three Musketeers,2011,90000000,20377913,119500000,139877913,49877913,0.3565817642703891,0.5541990333333333,10/20/11,5.7,1596,"['Adventure', 'Action', 'Thriller']"
The Promise,2017,90000000,8224288,2327129,10551417,-79448583,-7.529660045,-0.882762033,4/21/17,7.1,195,"['History', 'Romance', 'Drama']"
The Promise,2017,90000000,8224288,2327129,10551417,-79448583,-7.529660045,-0.882762033,4/21/17,7.1,195,"['History', 'Romance', 'Drama']"
The Nutcracker in 3D,2010,90000000,195459,20270557,20466016,-69533984,-3.397533941,-0.772599822,11/24/10,5.5,97,"['Music', 'Fantasy', 'Action', 'Family']"
Bright,2017,90000000,0,0,0,-90000000,#NAME?,-1,12/22/17,6.2,3181,"['Action', 'Crime', 'Fantasy']"
The Predator,2018,88000000,51024708,108462855,159487563,71487563,0.44823283806775577,0.8123586704545455,9/14/18,5.2,2018,"['Science Fiction', 'Action', 'Thriller', 'Adventure', 'Horror']"
The Bourne Supremacy,2004,85000000,176087450,134913674,311001124,226001124,0.7266890906799424,2.6588367529411765,7/23/04,7.3,4367,"['Action', 'Drama', 'Thriller']"
Divergent,2014,85000000,150947895,125067070,276014965,191014965,0.692045683,2.247234882352941,3/21/14,6.9,8279,"['Action', 'Adventure', 'Science Fiction']"
Hotel Transylvania,2012,85000000,148313048,230192764,378505812,293505812,0.7754327745963383,3.4530095529411766,9/28/12,6.9,5013,"['Animation', 'Comedy', 'Family', 'Fantasy']"
Safe House,2012,85000000,126181630,82360532,208542162,123542162,0.5924085605288776,1.4534372,2/10/12,6.4,1997,"['Action', 'Thriller']"
Tower Heist,2011,85000000,78046570,72376376,150422946,65422946,0.4349266367911715,0.7696817176470588,11/4/11,6,1592,"['Action', 'Comedy']"
Mirror Mirror,2012,85000000,64935167,108678315,173613482,88613482,0.5104066860429652,1.0425115529411764,3/30/12,5.8,2099,"['Adventure', 'Comedy', 'Drama', 'Family', 'Fantasy']"
Arthur Christmas,2011,85000000,46462469,103254655,149717124,64717124,0.4322626715698867,0.7613779294117647,11/23/11,6.7,692,"['Drama', 'Animation', 'Family', 'Comedy']"
xXx: Return of Xander Cage,2017,85000000,44898413,300134946,345033359,260033359,0.7536470089548646,3.059215988235294,1/20/17,5.6,2452,"['Action', 'Adventure', 'Crime']"
Cats & Dogs: The Revenge of Kitty Galore,2010,85000000,43585753,69440630,113026383,28026383,0.24796319457555321,0.32972215294117646,7/30/10,4.9,273,"['Comedy', 'Family', 'Action', 'Fantasy']"
The Greatest Showman,2017,84000000,174340174,212325376,386665550,302665550,0.7827579933097221,3.6031613095238093,12/20/17,8,5197,['Drama']
The Greatest Showman,2017,84000000,174340174,212325376,386665550,302665550,0.7827579933097221,3.6031613095238093,12/20/17,8,5197,['Drama']
RED 2,2013,84000000,53262560,88244795,141507355,57507355,0.40639127909641165,0.6846113690476191,7/19/13,6.5,2368,"['Action', 'Comedy', 'Crime', 'Thriller']"
Hellboy II: The Golden Army,2008,82500000,75986503,84401560,160388063,77888063,0.4856225678091767,0.9440977333333334,7/11/08,6.7,2820,"['Adventure', 'Fantasy']"
The Expendables,2010,82000000,103068524,165199650,268268174,186268174,0.6943357134864607,2.2715630975609757,8/3/10,6.1,4647,"['Thriller', 'Adventure', 'Action']"
The Hunger Games,2012,80000000,408010692,269912687,677923379,597923379,0.8819925636463409,7.474042238,3/23/12,7.1,14587,"['Science Fiction', 'Adventure', 'Fantasy']"
The Hangover Part II,2011,80000000,254464305,332000000,586464305,506464305,0.8635893108618093,6.330803813,5/25/11,6.4,6231,['Comedy']
The Lego Batman Movie,2017,80000000,175750384,134909634,310660018,230660018,0.7424837592071472,2.883250225,2/10/17,7.2,2882,"['Action', 'Animation', 'Comedy', 'Family', 'Fantasy']"
Hotel Transylvania 2,2015,80000000,169700110,299800188,469500298,389500298,0.8296060719433239,4.868753725,9/25/15,6.7,3184,"['Animation', 'Comedy', 'Family', 'Fantasy']"
Grown Ups 2,2013,80000000,133668525,113355283,247023808,167023808,0.6761445763154943,2.0877976,7/12/13,5.9,2090,['Comedy']
Alvin and the Chipmunks: Chipwrecked,2011,80000000,133107389,215981134,349088523,269088523,0.7708317669326528,3.363606538,12/16/11,5.5,1055,"['Comedy', 'Fantasy', 'Family', 'Music', 'Animation']"
Shutter Island,2010,80000000,128012934,171448848,299461782,219461782,0.7328540574837026,2.743272275,2/18/10,8.1,12625,"['Drama', 'Thriller', 'Mystery']"
Yogi Bear,2010,80000000,100246011,104528679,204774690,124774690,0.609326719,1.559683625,12/17/10,5.3,387,"['Comedy', 'Family', 'Animation', 'Adventure']"
The Book of Eli,2010,80000000,94835059,63915758,158750817,78750817,0.49606558560262404,0.984385213,1/11/10,6.7,3495,"['Action', 'Thriller', 'Science Fiction']"
Fury,2014,80000000,85817906,124497775,210315681,130315681,0.6196194234323402,1.628946013,10/17/14,7.4,6653,"['War', 'Drama', 'Action']"
Smallfoot,2018,80000000,83240103,130451174,213691277,133691277,0.625628144,1.671140963,9/28/18,6.6,600,"['Animation', 'Family', 'Adventure', 'Fantasy']"
Zookeeper,2011,80000000,80360866,90444659,170805525,90805525,0.5316310757512088,1.135069063,7/8/11,5.3,886,"['Comedy', 'Romance', 'Family']"
Conspiracy Theory,1997,80000000,76118990,66664728,142783718,62783718,0.43971202654913355,0.784796475,8/8/97,6.5,707,"['Action', 'Drama', 'Mystery', 'Thriller']"
Walking with Dinosaurs,2013,80000000,36076121,87292721,123368842,43368842,0.351538049,0.542110525,12/20/13,5.4,210,"['Animation', 'Family', 'Adventure']"
The Last Witch Hunter,2015,80000000,27367660,103451252,130818912,50818912,0.38846762461990203,0.6352364,10/23/15,5.8,2193,"['Fantasy', 'Action', 'Adventure', 'Science Fiction']"
The Last Witch Hunter,2015,80000000,27367660,103451252,130818912,50818912,0.38846762461990203,0.6352364,10/23/15,5.8,2193,"['Fantasy', 'Action', 'Adventure', 'Science Fiction']"
Pompeii,2014,80000000,23169033,85300000,108469033,28469033,0.2624623103259342,0.355862913,2/21/14,5.4,2078,"['Action', 'Adventure', 'History', 'Romance', 'Drama']"
Oceans,2010,80000000,19422319,67365211,86787530,6787530,0.078208586,0.084844125,4/21/10,7.2,167,"['Documentary', 'Family']"
The Lion King,1994,79300000,421785283,564429585,986214868,906914868,0.9195915590272769,11.43650527112232,6/23/94,8.2,10160,"['Family', 'Animation', 'Drama']"
Journey 2: The Mysterious Island,2012,79000000,103860290,214285872,318146162,239146162,0.7516864591313221,3.027166607594937,2/10/12,5.9,2152,"['Adventure', 'Action', 'Science Fiction']"
Jack and Jill,2011,79000000,74158157,76361060,150519217,71519217,0.47515007336239334,0.9053065443037974,11/11/11,4.1,1124,['Comedy']
Cloudy with a Chance of Meatballs 2,2013,78000000,119793567,154599082,274392649,196392649,0.7157358249783142,2.517854474358974,9/27/13,6.4,1679,"['Animation', 'Family', 'Comedy']"
The Little Prince,2016,77500000,1311213,100717706,102028919,24528919,0.24041143668296633,0.3165021806451613,8/5/16,7.6,1493,"['Adventure', 'Animation', 'Fantasy', 'Family']"
The Equalizer 2,2018,77000000,102084362,88368770,190453132,113453132,0.5957010567828309,1.4734172987012988,7/20/18,6.4,2089,"['Thriller', 'Action', 'Crime']"
Despicable Me 2,2013,76000000,368065385,607151450,975216835,899216835,0.922068614,11.831800460526315,7/3/13,6.9,7319,"['Animation', 'Comedy', 'Family']"
The Secret Life of Pets,2016,75000000,368384330,518366204,886750534,811750534,0.9154215338764036,10.823340453333333,7/8/16,6.1,5374,"['Adventure', 'Comedy', 'Animation', 'Family']"
Sing,2016,75000000,270329045,364125744,634454789,559454789,0.8817882671857332,7.459397186666667,12/21/16,6.9,4303,"['Animation', 'Comedy', 'Drama', 'Family']"
Sing,2016,75000000,270329045,364125744,634454789,559454789,0.8817882671857332,7.459397186666667,12/21/16,6.9,4303,"['Animation', 'Comedy', 'Drama', 'Family']"
Despicable Me 3,2017,75000000,264624300,770103450,1034727750,959727750,0.9275171657472219,12.79637,6/30/17,6.3,4106,"['Action', 'Animation', 'Comedy', 'Family', 'Adventure']"
Grown Ups,2010,75000000,162001186,110222244,272223430,197223430,0.724491018,2.629645733333333,6/24/10,6.1,3171,['Comedy']
Now You See Me,2013,75000000,117723989,225045211,342769200,267769200,0.7811938762292528,3.570256,5/31/13,7.4,9871,"['Thriller', 'Crime']"
Christopher Robin,2018,75000000,99215042,98289716,197504758,122504758,0.6202623128704575,1.6333967733333334,8/3/18,7.4,1280,"['Adventure', 'Comedy', 'Family', 'Fantasy']"
Immortals,2011,75000000,83504017,128058418,211562435,136562435,0.6454947212155125,1.8208324666666666,11/11/11,5.8,1431,"['Fantasy', 'Action', 'Drama']"
Killers,2010,75000000,47059963,48512786,95572749,20572749,0.21525747888658095,0.27430332,6/4/10,5.8,1314,"['Action', 'Comedy', 'Thriller', 'Romance']"
Sucker Punch,2011,75000000,36392502,53365887,89758389,14758389,0.16442350586305643,0.19677852,3/25/11,6,2716,"['Action', 'Fantasy', 'Thriller']"
Inferno,2016,75000000,34343574,185175793,219519367,144519367,0.6583444958640028,1.9269248933333334,10/28/16,5.9,3877,"['Mystery', 'Thriller', 'Drama']"
Inferno,2016,75000000,34343574,185175793,219519367,144519367,0.6583444958640028,1.9269248933333334,10/28/16,5.9,3877,"['Mystery', 'Thriller', 'Drama']"
Minions,2015,74000000,336045770,824290403,1160336173,1086336173,0.9362253787118641,14.680218554054054,7/10/15,6.4,7343,"['Family', 'Animation', 'Adventure', 'Comedy']"
The SpongeBob Movie: Sponge Out of Water,2015,74000000,162994032,148019149,311013181,237013181,0.7620679620006202,3.2028808243243243,2/6/15,5.7,1165,"['Adventure', 'Comedy', 'Family', 'Fantasy', 'Animation']"
The Angry Birds Movie,2016,73000000,107509366,244818521,352327887,279327887,0.7928066363932186,3.826409410958904,5/20/16,6,1851,"['Animation', 'Adventure', 'Comedy']"
Olympus Has Fallen,2013,70000000,98927592,73951336,172878928,102878928,0.5950923527244454,1.4696989714285715,3/22/13,6.2,4086,"['Action', 'Thriller']"
Battle: Los Angeles,2011,70000000,83552429,129911547,213463976,143463976,0.6720758166708185,2.0494853714285712,3/8/11,5.6,2049,"['Action', 'Science Fiction']"
War Horse,2011,70000000,79883359,76932170,156815529,86815529,0.5536156371350187,1.2402218428571428,12/25/11,7.2,1849,"['Drama', 'War']"
The Monuments Men,2014,70000000,78031620,80671128,158702748,88702748,0.5589238316150644,1.2671821142857143,2/7/14,5.9,2229,"['War', 'Drama', 'History', 'Action']"
Storks,2016,70000000,72679278,110674153,183353431,113353431,0.6182236698914022,1.6193347285714286,9/23/16,6.5,1308,"['Adventure', 'Animation', 'Comedy', 'Family']"
Underworld: Awakening,2012,70000000,62321039,98058891,160379930,90379930,0.5635364100732554,1.2911418571428572,1/19/12,6.2,2588,"['Fantasy', 'Action', 'Horror']"
The Lego Ninjago Movie,2017,70000000,59281555,63455646,122737201,52737201,0.429675767,0.7533885857142857,9/22/17,6.3,424,"['Action', 'Animation', 'Adventure', 'Family']"
Dracula Untold,2014,70000000,55991880,164249843,220241723,150241723,0.6821673975007906,2.1463103285714284,10/3/14,6.2,3719,"['Horror', 'Action', 'Drama', 'Fantasy', 'War']"
The Dilemma,2011,70000000,48475290,22071575,70546865,546865,0.007751797,0.007812357,1/13/11,5.3,448,"['Comedy', 'Drama']"
Rock of Ages,2012,70000000,38518613,22513319,61031932,-8968068,-0.146940588,-0.128115257,6/15/12,6.1,686,"['Comedy', 'Drama', 'Music', 'Romance']"
The Finest Hours,2016,70000000,27569558,21683203,49252761,-20747239,-0.421240121,-0.296389129,1/29/16,6.4,943,"['Action', 'Drama', 'History', 'Thriller']"
Escape Plan,2013,70000000,25135965,78600000,103735965,33735965,0.325209921,0.48194235714285716,10/18/13,6.7,2799,"['Action', 'Thriller']"
Killer Elite,2011,70000000,25124986,40284060,65409046,-4590954,-0.070188365,-0.065585057,9/23/11,6.2,1093,"['Action', 'Adventure', 'Thriller']"
The Legend of Hercules,2014,70000000,18848538,40104781,58953319,-11046681,-0.187380137,-0.157809729,1/10/14,4.5,805,"['Action', 'Adventure']"
Blackhat,2015,70000000,8005980,11659024,19665004,-50334996,-2.559622973,-0.719071371,1/16/15,5.3,1165,"['Crime', 'Thriller', 'Action']"
Despicable Me,2010,69000000,251513985,291950588,543464573,474464573,0.873036802,6.876298159,7/9/10,7.2,10057,"['Animation', 'Family', 'Comedy']"
Dinner for Schmucks,2010,69000000,73026337,13770165,86796502,17796502,0.20503708778494323,0.2579203188405797,7/30/10,5.6,920,['Comedy']
Red Sparrow,2018,69000000,46874505,99077356,145951861,76951861,0.5272413826912423,1.1152443623188406,3/2/18,6.5,3406,"['Mystery', 'Thriller']"
The Twilight Saga: Eclipse,2010,68000000,300531751,405571077,706102828,638102828,0.9036967459929222,9.383865117647058,6/23/10,6,4909,"['Adventure', 'Fantasy', 'Drama', 'Romance']"
Ted 2,2015,68000000,81476385,135737758,217214143,149214143,0.6869448781702948,2.194325632352941,6/26/15,6.1,4227,['Comedy']
Hall Pass,2011,68000000,45060734,42112741,87173475,19173475,0.21994620496659104,0.2819628676470588,2/25/11,5.5,1009,"['Comedy', 'Romance']"
Downsizing,2017,68000000,24449754,30013217,54462971,-13537029,-0.248554729,-0.199073956,12/22/17,5.1,1887,"['Comedy', 'Drama', 'Science Fiction']"
Downsizing,2017,68000000,24449754,30013217,54462971,-13537029,-0.248554729,-0.199073956,12/22/17,5.1,1887,"['Comedy', 'Drama', 'Science Fiction']"
Abraham Lincoln: Vampire Hunter,2012,67500000,37519139,99970591,137489730,69989730,0.5090542399057734,1.0368848888888889,6/22/12,5.6,2009,"['Action', 'Fantasy', 'Horror']"
Need for Speed,2014,66000000,43568507,150601112,194169619,128169619,0.6600910052771953,1.9419639242424243,3/14/14,6.1,2389,"['Action', 'Crime', 'Drama', 'Thriller']"
Lincoln,2012,65000000,182207973,91138308,273346281,208346281,0.7622063861187122,3.2053274,11/16/12,6.8,2261,"['History', 'Drama']"
Apollo 13,1995,65000000,173772767,162029504,335802271,270802271,0.8064337093181838,4.166188784615384,6/30/95,7.4,2821,"['Drama', 'History']"
Hotel Transylvania 3: Summer Vacation,2018,65000000,167500092,359579870,527079962,462079962,0.8766790531111103,7.108922492307692,6/30/18,6.8,1673,"['Family', 'Fantasy', 'Comedy', 'Animation']"
Unbroken,2014,65000000,115637895,47889929,163527824,98527824,0.602514126,1.5158126769230769,12/25/14,7.4,2240,"['Drama', 'War']"
Due Date,2010,65000000,100539043,111200000,211739043,146739043,0.6930183537289342,2.2575237384615385,11/4/10,6.3,2973,"['Comedy', 'Drama']"
Annie,2014,65000000,85911262,53918363,139829625,74829625,0.5351485781357134,1.151225,12/19/14,6.1,770,"['Comedy', 'Drama', 'Family']"
The Dictator,2012,65000000,59650222,120498675,180148897,115148897,0.6391873551132539,1.7715214923076923,5/16/12,6,3042,['Comedy']
This Means War,2012,65000000,54760791,102213766,156974557,91974557,0.5859201564747847,1.4149931846153847,2/17/12,6,2096,"['Action', 'Comedy', 'Romance']"
Focus,2015,65000000,53862963,114202737,168065700,103065700,0.6132464863443284,1.5856261538461538,2/27/15,6.8,4173,"['Romance', 'Comedy', 'Crime', 'Drama']"
Blade: Trinity,2004,65000000,52397389,78955776,131353165,66353165,0.5051508656072353,1.020817923076923,12/8/04,5.7,2058,"['Science Fiction', 'Action', 'Horror', 'Thriller', 'Adventure', 'Fantasy']"
Red Dawn,2012,65000000,44806783,3357367,48164150,-16835850,-0.349551482,-0.259013077,11/21/12,5.4,849,"['War', 'Action', 'Thriller', 'Science Fiction']"
Everest,2015,65000000,43482270,177814791,221297061,156297061,0.7062771656059182,2.404570169230769,9/18/15,6.7,2874,"['Adventure', 'Drama']"
Everest,2015,65000000,43482270,177814791,221297061,156297061,0.7062771656059182,2.404570169230769,9/18/15,6.7,2874,"['Adventure', 'Drama']"
Resident Evil: Retribution,2012,65000000,42345531,198302098,240647629,175647629,0.7298955311959463,2.7022712153846156,9/14/12,5.7,2321,"['Action', 'Horror', 'Science Fiction']"
"I, Frankenstein",2014,65000000,19075290,55500000,74575290,9575290,0.12839762339509508,0.14731215384615384,1/24/14,5.2,1090,"['Horror', 'Thriller']"
Sin City: A Dame to Kill For,2014,65000000,13757804,26893038,40650842,-24349158,-0.59898287,-0.374602431,8/22/14,6.3,2210,"['Crime', 'Thriller']"
Live by Night,2016,65000000,10378555,11395877,21774432,-43225568,-1.985152494,-0.665008738,12/25/16,6.2,759,"['Crime', 'Drama', 'Thriller']"
Live by Night,2016,65000000,10378555,11395877,21774432,-43225568,-1.985152494,-0.665008738,12/25/16,6.2,759,"['Crime', 'Drama', 'Thriller']"
Air Strike,2018,65000000,0,516279,516279,-64483721,-124.9009179,-0.992057246,10/26/18,3.9,56,"['Drama', 'War', 'Action', 'Adventure']"
Hop,2011,63000000,108085305,80572288,188657593,125657593,0.6660616782066121,1.9945649682539683,4/1/11,5.6,611,"['Animation', 'Comedy', 'Family']"
American Assassin,2017,63000000,36249674,32060466,68310140,5310140,0.077735751,0.084287937,9/15/17,6.3,1596,"['Action', 'Thriller']"
The Hateful Eight,2015,62000000,54117416,93747470,147864886,85864886,0.5806982869482616,1.3849175161290324,12/25/15,7.7,8065,"['Crime', 'Drama', 'Mystery', 'Western']"
The Hateful Eight,2015,62000000,54117416,93747470,147864886,85864886,0.5806982869482616,1.3849175161290324,12/25/15,7.7,8065,"['Crime', 'Drama', 'Mystery', 'Western']"
Gone Girl,2014,61000000,167767189,200800000,368567189,307567189,0.8344942202654941,5.042085065573771,10/3/14,7.9,10459,"['Mystery', 'Thriller', 'Drama']"
Maze Runner: The Scorch Trials,2015,61000000,81697192,228868970,310566162,249566162,0.8035845257346484,4.091248557,9/18/15,6.6,6365,"['Action', 'Science Fiction', 'Thriller']"
2 Guns,2013,61000000,75612460,56880555,132493015,71493015,0.5395983705254198,1.1720166393442624,8/2/13,6.5,2368,"['Action', 'Comedy', 'Crime']"
Maze Runner: The Death Cure,2018,61000000,58032443,207846093,265878536,204878536,0.7705719276263805,3.358664524590164,1/26/18,7,3894,"['Action', 'Science Fiction']"
The Lego Movie,2014,60000000,257784718,199944670,457729388,397729388,0.8689181827232819,6.628823133333333,2/7/14,7.4,4839,"['Adventure', 'Animation', 'Comedy', 'Family', 'Fantasy']"
Sully,2016,60000000,125070033,113454523,238524556,178524556,0.7484535722183673,2.9754092666666665,9/9/16,7.1,3924,"['Drama', 'History']"
The Bourne Identity,2002,60000000,121468960,92888411,214357371,154357371,0.7200936001403003,2.57262285,6/14/02,7.4,5406,"['Action', 'Drama', 'Mystery', 'Thriller']"
Eat Pray Love,2010,60000000,80574010,126024779,206598789,146598789,0.7095820343845287,2.44331315,8/12/10,6,1208,['Drama']
Jack Reacher,2012,60000000,80070736,137300000,217370736,157370736,0.723973884,2.6228456,12/21/12,6.4,4155,"['Crime', 'Drama', 'Thriller', 'Action']"
Contagion,2011,60000000,75658097,61893497,137551594,77551594,0.5638000385513526,1.2925265666666668,9/9/11,6.3,2128,"['Drama', 'Thriller', 'Science Fiction']"
London Has Fallen,2016,60000000,62524260,132669825,195194085,135194085,0.6926136363199735,2.25323475,3/4/16,5.9,2591,"['Action', 'Thriller']"
Jack Reacher: Never Go Back,2016,60000000,58697076,101249413,159946489,99946489,0.6248745416349839,1.6657748166666666,10/21/16,5.6,2831,"['Action', 'Thriller']"
Jack Reacher: Never Go Back,2016,60000000,58697076,101249413,159946489,99946489,0.6248745416349839,1.6657748166666666,10/21/16,5.6,2831,"['Action', 'Thriller']"
Baywatch,2017,60000000,58060186,117803597,175863783,115863783,0.6588268546457914,1.93106305,5/26/17,6.1,4748,"['Action', 'Comedy']"
Joy,2015,60000000,56451232,44682827,101134059,41134059,0.40672805389923095,0.68556765,12/25/15,6.5,2723,"['Drama', 'Comedy']"
ParaNorman,2012,60000000,56003051,52116611,108119662,48119662,0.44505930845399794,0.8019943666666667,8/17/12,6.8,1358,"['Family', 'Animation', 'Adventure', 'Comedy']"
The Tale of Despereaux,2008,60000000,50877145,39605172,90482317,30482317,0.33688700743593913,0.5080386166666667,12/19/08,5.8,464,"['Adventure', 'Animation', 'Family']"
The Tale of Despereaux,2008,60000000,50877145,39605172,90482317,30482317,0.33688700743593913,0.5080386166666667,12/19/08,5.8,464,"['Adventure', 'Animation', 'Family']"
The Boxtrolls,2014,60000000,50837305,61108946,111946251,51946251,0.46402850060606315,0.86577085,9/26/14,6.7,1016,"['Animation', 'Comedy', 'Family', 'Fantasy']"
The Dark Tower,2017,60000000,50701325,62760202,113461527,53461527,0.4711863872588283,0.89102545,8/4/17,5.6,2842,"['Action', 'Fantasy', 'Science Fiction', 'Western', 'Horror']"
Jack Ryan: Shadow Recruit,2014,60000000,50577412,80800000,131377412,71377412,0.5433004876058908,1.1896235333333334,1/17/14,6.1,1687,"['Action', 'Drama', 'Thriller']"
Vice,2018,60000000,47836282,23046889,70883171,10883171,0.1535367400535735,0.18138618333333334,12/25/18,7.1,1213,"['Drama', 'History', 'Comedy']"
Gangster Squad,2013,60000000,46000903,58100000,104100903,44100903,0.423636124,0.73501505,1/11/13,6.3,2527,"['Crime', 'Drama', 'Action', 'Thriller']"
Smurfs: The Lost Village,2017,60000000,45020282,152558304,197578586,137578586,0.6963233657315474,2.292976433333333,4/7/17,6.2,736,"['Adventure', 'Animation', 'Comedy', 'Family']"
First Man,2018,60000000,44936545,60267280,105203825,45203825,0.4296785311750785,0.7533970833333333,10/12/18,7.1,2304,"['History', 'Drama']"
Edge of Darkness,2010,60000000,43313890,39498566,82812456,22812456,0.2754713131560788,0.3802076,1/29/10,6.3,794,"['Crime', 'Drama', 'Mystery', 'Thriller']"
Trouble with the Curve,2012,60000000,35763137,12055776,47818913,-12181087,-0.254733666,-0.203018117,9/21/12,6.7,613,"['Drama', 'Romance']"
Almost Famous,2000,60000000,32522352,14848839,47371191,-12628809,-0.266592601,-0.21048015,9/15/00,7.5,1339,"['Drama', 'Music']"
The Mortal Instruments: City of Bones,2013,60000000,31165421,44800146,75965567,15965567,0.2101684701438482,0.26609278333333336,8/21/13,6.3,2915,"['Action', 'Adventure', 'Drama', 'Mystery', 'Romance', 'Fantasy']"
Priest,2011,60000000,29136626,55017400,84154026,24154026,0.2870216334034928,0.4025671,5/13/11,5.5,1157,"['Fantasy', 'Horror']"
Rock Dog,2017,60000000,9420546,14727942,24148488,-35851512,-1.484627609,-0.5975252,2/24/17,5.7,123,"['Adventure', 'Animation', 'Comedy', 'Family', 'Music']"
Mortdecai,2015,60000000,7696134,22700000,30396134,-29603866,-0.973935238,-0.493397767,1/23/15,5.4,1666,"['Comedy', 'Adventure']"
The Ridiculous 6,2015,60000000,0,0,0,-60000000,#NAME?,-1,12/11/15,5,676,"['Comedy', 'Western']"
Sherlock Gnomes,2018,59000000,43242871,44284780,87527651,28527651,0.3259273003910501,0.48351950847457625,3/23/18,5.4,343,"['Romance', 'Animation', 'Comedy', 'Family', 'Fantasy', 'Mystery', 'Adventure']"
Deadpool,2016,58000000,363070709,437954884,801025593,743025593,0.9275928253643202,12.810786086206896,2/12/16,7.6,20175,"['Action', 'Adventure', 'Comedy']"
American Sniper,2014,58000000,350126372,197200000,547326372,489326372,0.894030321,8.436661586206897,12/25/14,7.4,7658,"['War', 'Action']"
American Sniper,2014,58000000,350126372,197200000,547326372,489326372,0.894030321,8.436661586206897,12/25/14,7.4,7658,"['War', 'Action']"
Goosebumps,2015,58000000,80069458,78835866,158905324,100905324,0.6350027894597163,1.7397469655172413,10/16/15,6.2,2147,"['Adventure', 'Horror', 'Comedy']"
Goosebumps,2015,58000000,80069458,78835866,158905324,100905324,0.6350027894597163,1.7397469655172413,10/16/15,6.2,2147,"['Adventure', 'Horror', 'Comedy']"
Red Tails,2012,58000000,49876377,489121,50365498,-7634502,-0.151581982,-0.131629345,1/11/12,6,256,"['Drama', 'Action', 'Adventure', 'History', 'War']"
The Internship,2013,58000000,44672764,49000000,93672764,35672764,0.3808232241337514,0.6150476551724138,6/7/13,6.2,2631,['Comedy']
Life,2017,58000000,30234022,70695644,100929666,42929666,0.4253423963574793,0.7401666551724138,3/24/17,6.4,4180,"['Horror', 'Science Fiction', 'Thriller']"
Resident Evil: Afterlife,2010,57500000,60128566,235745624,295874190,238374190,0.805660642,4.145638086956522,9/10/10,5.9,2119,"['Action', 'Adventure', 'Horror', 'Science Fiction']"
That's My Boy,2012,57500000,36931089,21154146,58085235,585235,0.010075452049044822,0.010178,6/15/12,5.5,831,['Comedy']
Into the Woods,2014,56200000,128002372,85114029,213116401,156916401,0.7362943455487502,2.7921067793594307,12/25/14,5.7,2880,"['Fantasy', 'Comedy']"
Bohemian Rhapsody,2018,55000000,216303339,678682003,894985342,839985342,0.9385464795690475,15.272460763636364,11/2/18,8.1,7629,"['Drama', 'Music']"
Fifty Shades Darker,2017,55000000,114434010,266964482,381398492,326398492,0.8557938713611903,5.934518036363636,2/10/17,6.1,4489,"['Drama', 'Romance']"
Captain Phillips,2013,55000000,107136417,113511767,220648184,165648184,0.7507344089448749,3.0117851636363637,10/11/13,7.6,3909,"['Action', 'Drama', 'Thriller']"
Murder on the Orient Express,2017,55000000,102826543,243096187,345922730,290922730,0.8410049550661213,5.289504181818182,11/10/17,6.7,5406,"['Crime', 'Drama', 'Mystery']"
Murder on the Orient Express,2017,55000000,102826543,243096187,345922730,290922730,0.8410049550661213,5.289504181818182,11/10/17,6.7,5406,"['Crime', 'Drama', 'Mystery']"
The Equalizer,2014,55000000,101530738,91372886,192903624,137903624,0.7148835316852316,2.507338618181818,9/26/14,7.2,4989,"['Thriller', 'Action', 'Crime']"
Fifty Shades Freed,2018,55000000,100407760,270942859,371350619,316350619,0.851891993,5.751829436363637,2/9/18,6.1,3535,"['Drama', 'Romance']"
Date Night,2010,55000000,98711404,53557629,152269033,97269033,0.6387972070460315,1.7685278727272726,4/8/10,6,1743,['Comedy']
Paddington,2015,55000000,76223578,182565519,258789097,203789097,0.7874717264460334,3.705256309090909,1/16/15,7,1904,"['Comedy', 'Adventure', 'Family']"
Executive Decision,1996,55000000,56679192,65400000,122079192,67079192,0.5494727717398392,1.2196216727272726,3/15/96,6.1,402,"['Action', 'Adventure', 'Drama', 'Thriller']"
Free Birds,2013,55000000,55750480,54636592,110387072,55387072,0.5017532487862347,1.0070376727272727,11/1/13,5.8,410,"['Animation', 'Comedy', 'Family']"
Muppets Most Wanted,2014,55000000,51178893,28133408,79312301,24312301,0.30653884319911484,0.44204183636363636,3/21/14,6.2,473,"['Comedy', 'Adventure', 'Crime', 'Family']"
Kubo and the Two Strings,2016,55000000,48023088,29525034,77548122,22548122,0.2907629665100078,0.40996585454545453,8/19/16,7.7,2029,"['Animation', 'Adventure', 'Family']"
Burlesque,2010,55000000,39440655,51112020,90552675,35552675,0.3926187161229638,0.6464122727272728,11/23/10,7.1,1195,"['Drama', 'Romance']"
The Watch,2012,55000000,34353000,32777045,67130045,12130045,0.1806947246944345,0.22054627272727273,7/27/12,5.4,1356,"['Action', 'Comedy', 'Science Fiction']"
Annihilation,2018,55000000,32732301,10338614,43070915,-11929085,-0.276963817,-0.216892455,2/23/18,6.3,4465,['Science Fiction']
Crimson Peak,2015,55000000,31090320,43876534,74966854,19966854,0.26634242914875417,0.3630337090909091,10/16/15,6.5,2986,"['Drama', 'Fantasy', 'Horror', 'Mystery', 'Romance', 'Thriller']"
Crimson Peak,2015,55000000,31090320,43876534,74966854,19966854,0.26634242914875417,0.3630337090909091,10/16/15,6.5,2986,"['Drama', 'Fantasy', 'Horror', 'Mystery', 'Romance', 'Thriller']"
Bullet to the Head,2013,55000000,9489829,13108140,22597969,-32402031,-1.433847042,-0.589127836,2/1/13,5.4,681,"['Action', 'Crime', 'Thriller']"
Black Mass,2015,53000000,62575678,36262194,98837872,45837872,0.4637683012843498,0.8648655094339622,9/18/15,6.4,2020,"['Drama', 'Crime']"
Zero Dark Thirty,2012,52500000,95720716,38891719,134612435,82112435,0.6099914543556099,1.564046380952381,12/19/12,6.9,2553,"['Thriller', 'Drama', 'History']"
The Break-Up,2006,52000000,118703275,87024032,205727307,153727307,0.7472382215162132,2.956294365384615,6/2/06,5.7,1480,"['Romance', 'Comedy']"
Valentine's Day,2010,52000000,110485654,107083674,217569328,165569328,0.7609957227059138,3.1840255384615386,2/11/10,5.8,1907,"['Comedy', 'Romance']"
The Change-Up,2011,52000000,37243418,38753649,75997067,23997067,0.3157630675404881,0.4614820576923077,8/5/11,6,1406,['Comedy']
Alpha,2018,51000000,35851379,63773494,99624873,48624873,0.48807964854319064,0.9534288823529412,8/17/18,5.9,1167,"['Adventure', 'Drama']"
The Adjustment Bureau,2011,50200000,62495645,64435680,126931325,76731325,0.6045105493068791,1.5285124501992031,3/4/11,6.6,2615,"['Science Fiction', 'Thriller', 'Romance']"
Ted,2012,50000000,218665740,337350887,556016627,506016627,0.9100746316350716,10.12033254,6/29/12,6.3,7727,"['Comedy', 'Fantasy']"
22 Jump Street,2014,50000000,191719337,139614539,331333876,281333876,0.849094815,5.62667752,6/13/14,6.9,5167,"['Crime', 'Comedy', 'Action']"
Central Intelligence,2016,50000000,127440871,89753934,217194805,167194805,0.769791916,3.3438961,6/17/16,6.3,3133,"['Action', 'Comedy', 'Mystery']"
Anchorman 2: The Legend Continues,2013,50000000,127352707,44833047,172185754,122185754,0.7096159302470517,2.44371508,12/18/13,6.1,1408,['Comedy']
Super 8,2011,50000000,127004179,130968566,257972745,207972745,0.8061810754465554,4.1594549,6/9/11,6.7,3934,"['Thriller', 'Science Fiction', 'Mystery']"
Creed II,2018,50000000,115715889,97875633,213591522,163591522,0.7659083116604225,3.27183044,11/21/18,6.7,2236,['Drama']
Peter Rabbit,2018,50000000,115234093,231902384,347136477,297136477,0.8559644309577987,5.94272954,2/9/18,6.5,650,"['Animation', 'Adventure', 'Family']"
The Mule,2018,50000000,103804407,67053269,170857676,120857676,0.7073587726898498,2.41715352,12/14/18,6.5,1584,"['Crime', 'Drama', 'Thriller']"
Non-Stop,2014,50000000,91742160,130640895,222383055,172383055,0.7751627254153874,3.4476611,2/28/14,6.8,3330,"['Action', 'Thriller', 'Mystery']"
The Emoji Movie,2017,50000000,86089513,130472799,216562312,166562312,0.7691195686902346,3.33124624,7/23/17,5.4,1447,"['Animation', 'Family', 'Comedy']"
The Post,2017,50000000,81903458,97845422,179748880,129748880,0.7218341499540915,2.5949776,12/22/17,7,2506,"['Drama', 'History']"
The Post,2017,50000000,81903458,97845422,179748880,129748880,0.7218341499540915,2.5949776,12/22/17,7,2506,"['Drama', 'History']"
We Bought a Zoo,2011,50000000,75624550,43104523,118729073,68729073,0.5788731543452714,1.37458146,12/23/11,6.7,1523,"['Drama', 'Comedy', 'Family']"
Moneyball,2011,50000000,75605492,35695343,111300835,61300835,0.5507670719631169,1.2260167,9/22/11,7.1,2255,['Drama']
American Reunion,2012,50000000,56758835,180040376,236799211,186799211,0.7888506478174034,3.73598422,4/6/12,6.2,2679,['Comedy']
Hansel & Gretel: Witch Hunters,2013,50000000,55703475,159246241,214949716,164949716,0.767387457,3.29899432,1/25/13,5.9,4548,"['Fantasy', 'Horror', 'Action']"
13 Hours: The Secret Soldiers of Benghazi,2016,50000000,52853219,16558151,69411370,19411370,0.27965692076096466,0.3882274,1/15/16,7,1573,"['Action', 'Drama', 'History', 'Thriller', 'War']"
American Made,2017,50000000,51342000,84227212,135569212,85569212,0.6311846970092295,1.71138424,9/29/17,6.7,2188,"['Action', 'Crime']"
American Made,2017,50000000,51342000,84227212,135569212,85569212,0.6311846970092295,1.71138424,9/29/17,6.7,2188,"['Action', 'Crime']"
The Book of Life,2014,50000000,50151543,47500000,97651543,47651543,0.4879753205742996,0.95303086,10/17/14,7.4,1228,"['Romance', 'Animation', 'Adventure', 'Comedy', 'Family', 'Fantasy']"
Into the Storm,2014,50000000,47602194,102827177,150429371,100429371,0.6676181009890682,2.00858742,8/8/14,5.8,1169,"['Action', 'Thriller']"
The Judge,2014,50000000,47119388,29000000,76119388,26119388,0.34313712559013215,0.52238776,10/10/14,7.3,2356,['Drama']
War Dogs,2016,50000000,43034523,43199980,86234503,36234503,0.4201856767238515,0.72469006,8/19/16,6.8,2387,"['Comedy', 'Crime', 'Drama']"
The Nice Guys,2016,50000000,36261763,23334984,59596747,9596747,0.16102803396299467,0.19193494,5/20/16,7.1,4272,"['Comedy', 'Crime', 'Mystery']"
Marmaduke,2010,50000000,33644788,56251142,89895930,39895930,0.4438012933399766,0.7979186,6/4/10,5.1,367,"['Family', 'Comedy']"
Hereafter,2010,50000000,32746941,75913329,108660270,58660270,0.5398502138822221,1.1732054,10/22/10,5.9,848,"['Drama', 'Fantasy']"
Assassins,1995,50000000,30306268,53000000,83306268,33306268,0.3998050662886495,0.66612536,10/6/95,6.2,666,"['Action', 'Adventure', 'Crime', 'Thriller']"
Zoolander 2,2016,50000000,28848693,26500000,55348693,5348693,0.096636302,0.10697386,2/12/16,4.7,1374,['Comedy']
The Host,2013,50000000,26623701,37853350,64477051,14477051,0.2245302906300724,0.28954102,3/29/13,6.2,2788,"['Action', 'Adventure', 'Romance', 'Science Fiction', 'Thriller']"
Run All Night,2015,50000000,26461644,40500000,66961644,16961644,0.2533038764699385,0.33923288,3/13/15,6.4,1684,"['Action', 'Drama', 'Thriller']"
Blood Work,2002,50000000,26199517,0,26199517,-23800483,-0.908432129,-0.47600966,8/6/02,6.2,356,"['Crime', 'Thriller']"
Your Highness,2011,50000000,21596445,4525193,26121638,-23878362,-0.914121925,-0.47756724,4/8/11,5.3,735,"['Comedy', 'Adventure', 'Fantasy']"
Snowden,2016,50000000,21587519,13793399,35380918,-14619082,-0.413191144,-0.29238164,9/16/16,7.1,2427,"['Drama', 'History', 'Crime', 'Thriller']"
Dream House,2011,50000000,21302340,20339826,41642166,-8357834,-0.200706034,-0.16715668,9/30/11,6,670,"['Drama', 'Thriller', 'Mystery']"
Free State of Jones,2016,50000000,20810036,2427216,23237252,-26762748,-1.151717423,-0.53525496,6/24/16,6.6,787,"['Action', 'Drama', 'History', 'War']"
Beautiful Creatures,2013,50000000,19452138,40830738,60282876,10282876,0.17057706404054113,0.20565752,2/14/13,5.7,1826,"['Fantasy', 'Drama', 'Romance']"
Drive Angry,2011,50000000,10721033,30321550,41042583,-8957417,-0.218246912,-0.17914834,2/24/11,5.3,959,"['Fantasy', 'Thriller', 'Action', 'Crime']"
Early Man,2018,50000000,8267544,37018346,45285890,-4714110,-0.104096662,-0.0942822,2/16/18,5.9,338,"['Family', 'Comedy', 'Animation', 'Adventure']"
Child 44,2015,50000000,1224330,6779891,8004221,-41995779,-5.246704083,-0.83991558,4/17/15,6.2,903,"['Crime', 'Thriller']"
Upside Down,2013,50000000,102118,26284921,26387039,-23612961,-0.894869674,-0.47225922,3/14/13,6.2,1645,"['Romance', 'Science Fiction', 'Drama', 'Fantasy']"
Chappie,2015,49000000,31569268,73432788,105002056,56002056,0.5333424709321882,1.1428991020408164,3/6/15,6.7,4995,"['Crime', 'Action', 'Science Fiction']"
Anna Karenina,2012,49000000,12816367,58188260,71004627,22004627,0.30990412779719273,0.44907402040816324,11/16/12,6.7,1265,"['Drama', 'Romance']"
Taken 3,2015,48000000,89256424,238400000,327656424,279656424,0.8535050849483726,5.8261755,1/9/15,6.1,3406,"['Thriller', 'Action']"
Instant Family,2018,48000000,67363237,52372951,119736188,71736188,0.5991186891635468,1.4945039166666667,11/16/18,7.6,782,"['Comedy', 'Drama']"
Tooth Fairy,2010,48000000,60022256,52588130,112610386,64610386,0.5737515720796836,1.3460497083333334,1/22/10,5.3,1058,"['Comedy', 'Family', 'Fantasy']"
The Infiltrator,2016,47500000,15436808,5281296,20718104,-26781896,-1.292680836,-0.563829389,7/13/16,6.6,943,"['Crime', 'Drama', 'Thriller']"
Arrival,2016,47000000,100546139,102581755,203127894,156127894,0.7686186811940264,3.321870085106383,11/11/16,7.4,10387,"['Drama', 'Science Fiction', 'Mystery']"
Arrival,2016,47000000,100546139,102581755,203127894,156127894,0.7686186811940264,3.321870085106383,11/11/16,7.4,10387,"['Drama', 'Science Fiction', 'Mystery']"
Jonah Hex,2010,47000000,10547117,475579,11022696,-35977304,-3.263929623,-0.765474553,6/18/10,4.6,708,"['Action', 'Western', 'Drama', 'Fantasy', 'Thriller']"
Silence,2016,46500000,7100177,16626449,23726626,-22773374,-0.959823533,-0.489749978,12/23/16,7.1,1560,"['Drama', 'History']"
Silence,2016,46500000,7100177,16626449,23726626,-22773374,-0.959823533,-0.489749978,12/23/16,7.1,1560,"['Drama', 'History']"
Prisoners,2013,46000000,61002302,52400000,113402302,67402302,0.5943644953521314,1.4652674347826087,9/21/13,8,5785,"['Drama', 'Thriller', 'Crime']"
Taken 2,2012,45000000,139854287,237953117,377807404,332807404,0.8808916936948118,7.395720088888889,10/4/12,6.2,4035,"['Action', 'Crime', 'Thriller']"
Pitch Perfect 3,2017,45000000,104897530,80838882,185736412,140736412,0.7577211731644735,3.1274758222222223,12/22/17,6.5,1884,"['Comedy', 'Music']"
Pitch Perfect 3,2017,45000000,104897530,80838882,185736412,140736412,0.7577211731644735,3.1274758222222223,12/22/17,6.5,1884,"['Comedy', 'Music']"
The Muppets,2011,45000000,88625922,72346000,160971922,115971922,0.7204481412603124,2.5771538222222223,11/23/11,6.6,831,"['Comedy', 'Family', 'Music']"
The Girl on the Train,2016,45000000,75395035,98883179,174278214,129278214,0.7417921668625775,2.8728492,10/7/16,6.3,3479,"['Crime', 'Drama', 'Mystery', 'Romance', 'Thriller']"
The Girl on the Train,2016,45000000,75395035,98883179,174278214,129278214,0.7417921668625775,2.8728492,10/7/16,6.3,3479,"['Crime', 'Drama', 'Mystery', 'Romance', 'Thriller']"
Blade,1998,45000000,70141876,61095812,131237688,86237688,0.6571106921664149,1.9163930666666666,8/21/98,6.6,3137,"['Horror', 'Action']"
The Bounty Hunter,2010,45000000,67061228,68747609,135808837,90808837,0.6686519007595949,2.0179741555555557,3/19/10,5.7,1627,"['Action', 'Comedy', 'Drama']"
Office Christmas Party,2016,45000000,54767494,36555805,91323299,46323299,0.507245134,1.0294066444444445,12/9/16,5.6,1191,['Comedy']
Savages,2012,45000000,47323100,35190390,82513490,37513490,0.4546346300465536,0.8336331111111112,7/6/12,6.3,1246,"['Crime', 'Drama', 'Thriller']"
Blended,2014,45000000,46290741,81700000,127990741,82990741,0.6484120675572931,1.8442386888888889,5/23/14,6.7,1709,['Comedy']
All Eyez on Me,2017,45000000,44922302,9954553,54876855,9876855,0.17998216187862806,0.21948566666666666,6/16/17,6.4,695,"['Drama', 'Music']"
The Ghost Writer,2010,45000000,15541549,49990942,65532491,20532491,0.3133177250960901,0.4562775777777778,2/12/10,6.8,1135,"['Thriller', 'Mystery']"
Dredd,2012,45000000,13414714,28052892,41467606,-3532394,-0.085184421,-0.078497644,9/21/12,6.7,2788,"['Action', 'Science Fiction']"
The Rum Diary,2011,45000000,13109815,8434917,21544732,-23455268,-1.088677641,-0.521228178,10/27/11,5.7,652,"['Drama', 'Comedy']"
Welcome to Marwen,2018,45000000,10763520,2111402,12874922,-32125078,-2.495166806,-0.713890622,12/21/18,6.6,286,"['Drama', 'Comedy', 'Fantasy']"
Johnny English Reborn,2011,45000000,8406711,156233690,164640401,119640401,0.7266770505497008,2.6586755777777777,10/21/11,6.1,1810,"['Crime', 'Adventure', 'Action', 'Comedy', 'Thriller']"
Argo,2012,44500000,136025503,91115254,227140757,182640757,0.8040862389130806,4.104286674157303,10/12/12,7.2,5127,"['Drama', 'Thriller']"
Charlie St. Cloud,2010,44000000,31206263,17271821,48478084,4478084,0.09237337,0.10177463636363636,5/1/10,6.9,1398,"['Drama', 'Romance']"
The Interview,2014,44000000,6105175,6237457,12342632,-31657368,-2.564879841,-0.719485636,12/25/14,6.2,3579,"['Action', 'Comedy']"
The Heat,2013,43000000,159581587,70146187,229727774,186727774,0.8128219359318739,4.342506372093023,6/28/13,6.6,2441,"['Action', 'Comedy', 'Crime']"
The Mechanic,2011,42500000,29121498,47225895,76347393,33847393,0.44333397212397285,0.7964092470588235,1/28/11,6.3,1676,"['Action', 'Thriller', 'Crime']"
21 Jump Street,2012,42000000,138447667,64364762,202812429,160812429,0.7929121000764702,3.8288673571428573,3/12/12,6.8,6527,"['Action', 'Comedy', 'Crime']"
Snatched,2017,42000000,45852178,11999999,57852177,15852177,0.2740117627725574,0.37743278571428573,5/12/17,5.3,495,"['Action', 'Comedy']"
Here Comes the Boom,2012,42000000,45290318,27948940,73239258,31239258,0.42653706295058313,0.7437918571428571,10/12/12,6,812,"['Action', 'Comedy']"
Red Riding Hood,2011,42000000,37662162,54016280,91678442,49678442,0.5418770314617694,1.1828200476190476,3/11/11,5.9,1884,"['Fantasy', 'Thriller', 'Horror']"
Holmes & Watson,2018,42000000,30568743,11357862,41926605,-73395,-0.001750559,-0.0017475,12/25/18,4.1,217,"['Mystery', 'Adventure', 'Comedy', 'Crime']"
One for the Money,2012,42000000,26414527,9782694,36197221,-5802779,-0.160310069,-0.138161405,1/27/12,5.5,615,"['Action', 'Comedy', 'Crime']"
Man on a Ledge,2012,42000000,18620000,31001440,49621440,7621440,0.15359167327671264,0.18146285714285715,1/27/12,6.3,1460,"['Action', 'Thriller', 'Crime']"
The Warrior's Way,2010,42000000,5666340,2847985,8514325,-33485675,-3.932863145,-0.797277976,12/3/10,6.1,203,"['Adventure', 'Fantasy', 'Action', 'Western', 'Thriller']"
The Big Year,2011,41000000,7204138,480386,7684524,-33315476,-4.335398783,-0.812572585,10/14/11,5.8,393,['Comedy']
The Karate Kid,2010,40000000,176591618,175183320,351774938,311774938,0.886290933,7.79437345,6/10/10,6.3,3140,"['Action', 'Adventure', 'Drama', 'Family']"
Fifty Shades of Grey,2015,40000000,166167230,404830871,570998101,530998101,0.9299472276178375,13.27495253,2/13/15,5.4,6451,"['Drama', 'Romance', 'Thriller']"
American Hustle,2013,40000000,150117807,107760487,257878294,217878294,0.8448880695635438,5.44695735,12/12/13,6.8,4443,"['Drama', 'Crime']"
American Hustle,2013,40000000,150117807,107760487,257878294,217878294,0.8448880695635438,5.44695735,12/12/13,6.8,4443,"['Drama', 'Crime']"
Lucy,2014,40000000,126573960,330933816,457507776,417507776,0.9125697920378079,10.4376944,7/25/14,6.3,10019,"['Action', 'Science Fiction']"
Lone Survivor,2013,40000000,125095601,24709031,149804632,109804632,0.7329855594852367,2.7451158,12/24/13,7.4,2289,"['Action', 'Drama', 'War']"
The Social Network,2010,40000000,96962694,127959441,224922135,184922135,0.8221606779608419,4.623053375,10/1/10,7.2,6116,['Drama']
Ride Along 2,2016,40000000,90862685,33964631,124827316,84827316,0.679557317,2.1206829,1/15/16,6.2,939,"['Action', 'Comedy']"
Get Hard,2015,40000000,90411453,16100000,106511453,66511453,0.6244535317718368,1.662786325,3/27/15,6,1469,['Comedy']
The Accountant,2016,40000000,86260045,66702038,152962083,112962083,0.7384972849774804,2.824052075,10/14/16,6.9,3407,"['Crime', 'Thriller', 'Drama']"
The Accountant,2016,40000000,86260045,66702038,152962083,112962083,0.7384972849774804,2.824052075,10/14/16,6.9,3407,"['Crime', 'Thriller', 'Drama']"
Dumb and Dumber To,2014,40000000,86208010,70345582,156553592,116553592,0.744496441,2.9138398,11/14/14,5.5,1842,['Comedy']
The Other Woman,2014,40000000,83911193,111200000,195111193,155111193,0.7949886965223979,3.877779825,4/25/14,6.3,2276,"['Comedy', 'Romance']"
The Intern,2015,40000000,75764672,121351038,197115710,157115710,0.7970735057089057,3.92789275,9/25/15,7.1,3373,['Comedy']
Bridge of Spies,2015,40000000,72313754,90184584,162498338,122498338,0.7538436362346057,3.06245845,10/16/15,7.2,4313,"['Thriller', 'Drama']"
Bridge of Spies,2015,40000000,72313754,90184584,162498338,122498338,0.7538436362346057,3.06245845,10/16/15,7.2,4313,"['Thriller', 'Drama']"
"I Love You, Man",2009,40000000,72013010,20289492,92302502,52302502,0.5666422996854408,1.30756255,3/20/09,6.5,897,['Comedy']
Hacksaw Ridge,2016,40000000,67209615,101695067,168904682,128904682,0.7631800402075296,3.22261705,11/4/16,8.1,6608,"['Drama', 'History', 'War']"
Hacksaw Ridge,2016,40000000,67209615,101695067,168904682,128904682,0.7631800402075296,3.22261705,11/4/16,8.1,6608,"['Drama', 'History', 'War']"
Unknown,2011,40000000,63686397,72436686,136123083,96123083,0.7061482952160288,2.403077075,2/18/11,6.6,2043,"['Action', 'Mystery', 'Thriller']"
Get Him to the Greek,2010,40000000,61153526,30302349,91455875,51455875,0.5626306128501859,1.286396875,6/4/10,5.9,980,['Comedy']
Behind Enemy Lines,2001,40000000,58855732,0,58855732,18855732,0.32037205823894943,0.4713933,11/30/01,6.1,705,"['Action', 'Drama', 'Thriller', 'War']"
The Lincoln Lawyer,2011,40000000,58009200,29135886,87145086,47145086,0.5409953465419726,1.17862715,3/18/11,7.1,1525,"['Crime', 'Drama', 'Thriller']"
Horrible Bosses 2,2014,40000000,54445357,51500000,105945357,65945357,0.6224468808010152,1.648633925,11/26/14,6.2,2581,['Comedy']
Predators,2010,40000000,52000688,75233701,127234389,87234389,0.6856195851264708,2.180859725,7/3/10,6.1,1979,"['Action', 'Science Fiction', 'Adventure', 'Thriller']"
The Odd Life of Timothy Green,2012,40000000,51853450,3395709,55249159,15249159,0.276007079,0.381228975,8/15/12,6.7,605,"['Fantasy', 'Drama', 'Comedy', 'Family']"
Jersey Boys,2014,40000000,47047013,18235719,65282732,25282732,0.3872805445703467,0.6320683,6/20/14,6.9,380,"['Music', 'Drama']"
Final Destination 5,2011,40000000,42587643,112423522,155011165,115011165,0.7419540715018819,2.875279125,8/12/11,6,1701,"['Horror', 'Mystery']"
Widows,2018,40000000,42402632,31463456,73866088,33866088,0.4584795122763236,0.8466522,11/16/18,6.5,941,"['Crime', 'Thriller']"
Sex Tape,2014,40000000,38543473,87526036,126069509,86069509,0.6827147157366973,2.151737725,7/18/14,5.3,2684,['Comedy']
Scream 4,2011,40000000,38180928,57808662,95989590,55989590,0.5832881461416806,1.39973975,4/11/11,6.2,1610,"['Horror', 'Mystery']"
Paul,2011,40000000,37412945,63749161,101162106,61162106,0.6045950249394768,1.52905265,3/17/11,6.5,3017,"['Adventure', 'Comedy', 'Science Fiction']"
The Guilt Trip,2012,40000000,37134215,4160459,41294674,1294674,0.031352081868959665,0.03236685,12/19/12,5.4,403,['Comedy']
Colombiana,2011,40000000,36665854,35629408,72295262,32295262,0.44671339596224163,0.80738155,8/26/11,6.5,1371,"['Action', 'Thriller', 'Crime', 'Drama']"
The Commuter,2018,40000000,36343858,65641573,101985431,61985431,0.6077871161813299,1.549635775,1/12/18,6.2,2394,"['Action', 'Thriller']"
Arthur,2011,40000000,33035397,14752546,47787943,7787943,0.16296878482507607,0.194698575,4/8/11,5.5,399,"['Comedy', 'Romance']"
Patriots Day,2016,40000000,31886361,20951628,52837989,12837989,0.24296891768534187,0.320949725,12/21/16,6.9,1337,"['Action', 'Drama', 'Thriller', 'Crime', 'History']"
Patriots Day,2016,40000000,31886361,20951628,52837989,12837989,0.24296891768534187,0.320949725,12/21/16,6.9,1337,"['Action', 'Drama', 'Thriller', 'Crime', 'History']"
Morning Glory,2010,40000000,31011732,28783338,59795070,19795070,0.3310485295861348,0.49487675,11/10/10,6.3,717,"['Comedy', 'Drama', 'Romance']"
Grudge Match,2013,40000000,29807260,40000000,69807260,29807260,0.4269936966441599,0.7451815,12/25/13,6,711,['Comedy']
The Nut Job 2: Nutty by Nature,2017,40000000,28370522,29067867,57438389,17438389,0.303601638,0.435959725,8/11/17,5.7,227,"['Family', 'Animation', 'Adventure', 'Comedy']"
Resident Evil: The Final Chapter,2017,40000000,26844692,287256498,314101190,274101190,0.8726525041181793,6.85252975,1/27/17,5.9,1859,"['Action', 'Horror', 'Science Fiction']"
The House,2017,40000000,25584504,5607921,31192425,-8807575,-0.282362625,-0.220189375,6/30/17,5.7,474,['Comedy']
Season of the Witch,2011,40000000,24827228,66299372,91126600,51126600,0.5610502312167907,1.278165,1/7/11,5.3,1352,"['Adventure', 'Fantasy', 'Action']"
Mechanic: Resurrection,2016,40000000,21218403,88520437,109738840,69738840,0.635498243,1.743471,8/26/16,5.6,1929,"['Action', 'Crime', 'Thriller']"
Big Miracle,2012,40000000,20157300,5111380,25268680,-14731320,-0.582987319,-0.368283,2/3/12,6.6,250,"['Adventure', 'Drama', 'Romance']"
A Thousand Words,2012,40000000,18450127,2340359,20790486,-19209514,-0.923956948,-0.48023785,3/8/12,6.1,685,"['Drama', 'Comedy']"
The Gunman,2015,40000000,10664749,7929478,18594227,-21405773,-1.151205318,-0.535144325,3/20/15,5.7,583,"['Action', 'Drama', 'Crime']"
Paranoia,2013,40000000,7388654,8952113,16340767,-23659233,-1.447865513,-0.591480825,8/16/13,5.7,518,"['Drama', 'Thriller']"
The Hurricane Heist,2018,40000000,6115824,24847860,30963684,-9036316,-0.291835946,-0.2259079,3/9/18,5.4,476,"['Action', 'Crime', 'Thriller']"
Victor Frankenstein,2015,40000000,5775076,25349291,31124367,-8875633,-0.285166699,-0.221890825,11/10/15,5.8,1200,"['Drama', 'Science Fiction', 'Thriller']"
Victor Frankenstein,2015,40000000,5775076,25349291,31124367,-8875633,-0.285166699,-0.221890825,11/10/15,5.8,1200,"['Drama', 'Science Fiction', 'Thriller']"
Snowpiercer,2014,40000000,4563029,83506851,88069880,48069880,0.5458152094677544,1.201747,6/27/14,6.8,4748,"['Action', 'Science Fiction', 'Drama']"
Frankenweenie,2012,39000000,35287788,45863000,81150788,42150788,0.5194131694691615,1.080789435897436,10/5/12,6.8,1685,"['Animation', 'Comedy', 'Family']"
Captain Underpants: The First Epic Movie,2017,38000000,73921000,52656874,126577874,88577874,0.6997895540574492,2.3309966842105263,6/2/17,6,587,"['Action', 'Animation', 'Comedy', 'Family']"
Paul Blart: Mall Cop 2,2015,38000000,71091594,36559052,107650646,69650646,0.647006299,1.8329117368421053,4/17/15,5,900,"['Action', 'Comedy', 'Family']"
Why Him?,2016,38000000,60323786,57101370,117425156,79425156,0.6763896145047489,2.0901356842105265,12/23/16,6.2,2494,['Comedy']
Why Him?,2016,38000000,60323786,57101370,117425156,79425156,0.6763896145047489,2.0901356842105265,12/23/16,6.2,2494,['Comedy']
Water for Elephants,2011,38000000,58709717,58100000,116809717,78809717,0.6746845983712125,2.0739399210526317,4/22/11,6.9,1627,"['Drama', 'Romance']"
Riddick,2013,38000000,42025135,52738623,94763758,56763758,0.5990028170896304,1.4937831052631578,9/6/13,6.2,2852,"['Science Fiction', 'Action', 'Thriller']"
The 5th Wave,2016,38000000,34912982,76423416,111336398,73336398,0.6586920298966381,1.9299052105263157,1/15/16,5.8,3657,"['Adventure', 'Science Fiction']"
Rush,2013,38000000,26947624,71283215,98230839,60230839,0.6131561087450348,1.5850220789473684,9/27/13,7.7,3877,"['Drama', 'Action']"
Only the Brave,2017,38000000,18340051,6215126,24555177,-13444823,-0.547535169,-0.353811132,10/20/17,7,603,['Drama']
The Thing,2011,38000000,16999934,10573144,27573078,-10426922,-0.378155895,-0.274392684,10/14/11,6.1,1404,"['Horror', 'Science Fiction', 'Mystery', 'Thriller']"
The Sisters Brothers,2018,38000000,3143056,10000000,13143056,-24856944,-1.891260602,-0.654130105,9/21/18,7,590,"['Comedy', 'Drama', 'Western']"
The Upside,2019,37500000,108235497,10789039,119024536,81524536,0.6849389104108753,2.1739876266666665,1/11/19,7.3,274,"['Comedy', 'Drama']"
What to Expect When You're Expecting,2012,37500000,41152203,47320813,88473016,50973016,0.5761419504450939,1.3592804266666667,5/18/12,5.9,1130,"['Romance', 'Comedy', 'Drama']"
The Master,2012,37500000,16247159,34400257,50647416,13147416,0.2595871031209174,0.35059776,9/14/12,7.1,1323,['Drama']
We're the Millers,2013,37000000,150394119,117422157,267816276,230816276,0.8618455885033663,6.23827773,8/7/13,6.8,5231,"['Comedy', 'Crime']"
Creed,2015,37000000,109767581,63800000,173567581,136567581,0.7868265502876369,3.691015702702703,11/25/15,7.3,4010,['Drama']
Creed,2015,37000000,109767581,63800000,173567581,136567581,0.7868265502876369,3.691015702702703,11/25/15,7.3,4010,['Drama']
The Town,2010,37000000,92186262,60380619,152566881,115566881,0.7574834082109865,3.1234292162162163,9/17/10,7.1,2386,"['Crime', 'Drama', 'Thriller']"
Dolphin Tale,2011,37000000,72286779,23781945,96068724,59068724,0.6148590461136967,1.596452,9/23/11,6.8,327,"['Drama', 'Family']"
Game Night,2018,37000000,69179066,48199018,117378084,80378084,0.6847793153618013,2.1723806486486485,2/23/18,6.9,2756,"['Mystery', 'Comedy', 'Crime']"
Cop Out,2010,37000000,44875481,11034429,55909910,18909910,0.3382210774440524,0.5110786486486486,2/26/10,5.4,796,"['Action', 'Comedy', 'Crime']"
The Rite,2011,37000000,33047633,64096354,97143987,60143987,0.6191220770051367,1.6255131621621621,1/28/11,5.9,994,"['Drama', 'Thriller', 'Horror']"
Aloha,2015,37000000,21052030,4335061,25387091,-11612909,-0.457433622,-0.313862405,5/29/15,5.3,1226,"['Drama', 'Comedy', 'Romance']"
Hot Tub Time Machine,2010,36000000,50269859,15697891,65967750,29967750,0.4542787953204407,0.8324375,3/26/10,6,1383,"['Science Fiction', 'Comedy', 'Adventure']"
Dolphin Tale 2,2014,36000000,42024533,15800000,57824533,21824533,0.37742687865719554,0.6062370277777778,9/12/14,6.7,173,"['Family', 'Drama']"
Collateral Beauty,2016,36000000,31016021,54293072,85309093,49309093,0.5780051254325257,1.3696970277777778,12/16/16,7.2,3270,"['Drama', 'Romance']"
Collateral Beauty,2016,36000000,31016021,54293072,85309093,49309093,0.5780051254325257,1.3696970277777778,12/16/16,7.2,3270,"['Drama', 'Romance']"
There Be Dragons,2011,36000000,1069334,2951656,4020990,-31979010,-7.953019033,-0.888305833,5/6/11,5.1,93,"['Drama', 'War']"
It,2017,35000000,327481748,369976221,697457969,662457969,0.9498177645741402,18.927370542857144,9/8/17,7.2,10931,"['Horror', 'Thriller']"
It,2017,35000000,327481748,369976221,697457969,662457969,0.9498177645741402,18.927370542857144,9/8/17,7.2,10931,"['Horror', 'Thriller']"
True Grit,2010,35000000,171243005,81033923,252276928,217276928,0.8612635714352761,6.207912228571429,12/22/10,7.2,2816,"['Drama', 'Adventure', 'Western']"
Identity Thief,2013,35000000,134506920,40854658,175361578,140361578,0.80041238,4.0103308,2/9/13,5.8,2230,"['Comedy', 'Crime']"
Horrible Bosses,2011,35000000,117538559,94879042,212417601,177417601,0.8352302265196941,5.069074314285714,7/8/11,6.5,3842,"['Comedy', 'Crime']"
Trainwreck,2015,35000000,110212700,30911197,141123897,106123897,0.7519909757027189,3.0321113428571427,7/17/15,5.8,1731,"['Comedy', 'Romance']"
Saving Mr. Banks,2013,35000000,83299761,31662764,114962525,79962525,0.6955529638897545,2.2846435714285716,12/20/13,7.4,2050,"['Comedy', 'Drama', 'History']"
A Nightmare on Elm Street,2010,35000000,63075011,54654610,117729621,82729621,0.7027086326898139,2.363703457142857,4/30/10,5.5,1408,"['Horror', 'Mystery', 'Thriller']"
Secretariat,2010,35000000,59699513,676734,60376247,25376247,0.420301828,0.7250356285714286,10/8/10,7,200,['Drama']
Friends with Benefits,2011,35000000,55802754,90793137,146595891,111595891,0.7612484240775889,3.1884540285714285,7/21/11,6.6,4637,"['Romance', 'Comedy']"
Neighbors 2: Sorority Rising,2016,35000000,55340730,53416891,108757621,73757621,0.6781834718506761,2.1073606,5/20/16,5.7,2829,['Comedy']
Sicario: Day of the Soldado,2018,35000000,50065850,25819346,75885196,40885196,0.5387769704119891,1.168148457142857,6/29/18,6.7,1317,"['Action', 'Crime', 'Drama', 'Thriller']"
Poltergeist,2015,35000000,47425125,48287944,95713069,60713069,0.63432371,1.7346591142857142,5/22/15,5.1,1438,"['Horror', 'Thriller']"
Goosebumps 2: Haunted Halloween,2018,35000000,46697321,46594157,93291478,58291478,0.6248317558008889,1.6654708,10/12/18,5.6,428,"['Adventure', 'Comedy', 'Fantasy', 'Family', 'Horror']"
12 Strong,2018,35000000,45819713,25298665,71118378,36118378,0.5078627918088908,1.0319536571428571,1/19/18,5.6,1312,"['War', 'Drama', 'History', 'Action']"
Something Borrowed,2011,35000000,39046489,26037627,65084116,30084116,0.46223437989078625,0.8595461714285715,5/5/11,6.1,591,"['Comedy', 'Drama', 'Romance']"
In Time,2011,35000000,37553932,127550020,165103952,130103952,0.7880123426724516,3.7172557714285714,10/28/11,6.8,6245,"['Action', 'Thriller', 'Science Fiction']"
J. Edgar,2011,35000000,37306030,47300000,84606030,49606030,0.5863179019273212,1.4173151428571429,11/9/11,6.2,1303,"['Drama', 'Crime', 'History']"
Mile 22,2018,35000000,36108758,30186363,66295121,31295121,0.47205767978008517,0.8941463142857143,8/17/18,6,920,['Action']
Hot Pursuit,2015,35000000,34580201,11091311,45671512,10671512,0.23365795290508445,0.30490034285714285,5/8/15,5.6,1000,"['Action', 'Comedy', 'Crime']"
Concussion,2015,35000000,34531832,15831958,50363790,15363790,0.30505627157924375,0.43896542857142856,12/25/15,7.1,1435,['Drama']
The Foreigner,2017,35000000,34393507,106389853,140783360,105783360,0.7513910734905034,3.0223817142857143,10/13/17,6.7,1086,"['Action', 'Thriller', 'Drama']"
The Foreigner,2017,35000000,34393507,106389853,140783360,105783360,0.7513910734905034,3.0223817142857143,10/13/17,6.7,1086,"['Action', 'Thriller', 'Drama']"
Adrift,2018,35000000,31445011,26452180,57897191,22897191,0.39548017105009464,0.6542054571428572,6/1/18,6.7,1264,"['Thriller', 'Romance', 'Adventure']"
Underworld: Blood Wars,2017,35000000,30353973,50855249,81209222,46209222,0.569014465,1.3202634857142856,1/6/17,5.5,2318,"['Action', 'Fantasy', 'Horror', 'Drama']"
Nanny McPhee and the Big Bang,2010,35000000,29197642,68602223,97799865,62799865,0.6421262953686081,1.7942818571428572,8/20/10,6.1,953,"['Comedy', 'Fantasy', 'Family']"
Abduction,2011,35000000,28087155,58561204,86648359,51648359,0.5960685187355943,1.4756674,9/23/11,5.8,1791,"['Thriller', 'Action', 'Mystery']"
Alex Cross,2012,35000000,25888412,9538347,35426759,426759,0.012046233187743761,0.012193114285714285,10/18/12,5.1,424,"['Action', 'Thriller', 'Crime', 'Mystery']"
Whiskey Tango Foxtrot,2016,35000000,23083334,2267413,25350747,-9649253,-0.380629928,-0.275692943,3/4/16,6.2,596,"['War', 'Comedy']"
Hitman: Agent 47,2015,35000000,22467450,59715353,82182803,47182803,0.5741201477394242,1.3480800857142856,8/21/15,5.6,1764,"['Action', 'Crime', 'Thriller']"
Premium Rush,2012,35000000,20275446,11117755,31393201,-3606799,-0.114891087,-0.1030514,8/24/12,6.2,1244,"['Crime', 'Action', 'Thriller']"
Broken City,2013,35000000,19701164,14778881,34480045,-519955,-0.015079882,-0.014855857,1/18/13,5.9,814,"['Thriller', 'Crime', 'Drama']"
Furry Vengeance,2010,35000000,17630465,21709712,39340177,4340177,0.11032428755976365,0.12400505714285714,4/2/10,4.6,283,"['Comedy', 'Family']"
Parker,2013,35000000,17616641,30926747,48543388,13543388,0.27899552458102017,0.38695394285714285,1/25/13,5.8,1868,"['Action', 'Crime']"
The Tree of Life,2011,35000000,13305665,48416161,61721826,26721826,0.4329396541184637,0.7634807428571428,5/27/11,6.6,1730,"['Drama', 'Fantasy']"
Sabotage,2014,35000000,10508518,7867925,18376443,-16623557,-0.904612334,-0.474958771,3/28/14,5.5,779,"['Action', 'Drama', 'Thriller', 'Crime']"
Unfinished Business,2015,35000000,10219501,2994550,13214051,-21785949,-1.648695695,-0.622455686,3/6/15,5.2,472,['Comedy']
The Walk,2015,35000000,10161183,51330921,61492104,26492104,0.43082123194223443,0.7569172571428572,10/2/15,6.9,1906,"['Adventure', 'Drama', 'Thriller']"
Mandela: Long Walk to Freedom,2013,35000000,8323085,21567317,29890402,-5109598,-0.170944439,-0.145988514,12/25/13,6.9,319,"['Drama', 'History']"
The Snowman,2017,35000000,6670765,36555381,43226146,8226146,0.19030486779922504,0.23503274285714285,10/20/17,5.1,1225,"['Drama', 'Crime', 'Thriller', 'Horror']"
A Hologram for the King,2016,35000000,4212494,7633516,11846010,-23153990,-1.954581332,-0.661542571,4/22/16,5.9,589,"['Comedy', 'Drama']"
Stolen,2012,35000000,289773,17677973,17967746,-17032254,-0.947934927,-0.486635829,9/14/12,5.3,559,"['Action', 'Crime', 'Thriller']"
Trespass,2011,35000000,16816,769716,786532,-34213468,-43.49914307,-0.977527657,10/14/11,5.5,589,"['Crime', 'Drama', 'Thriller', 'Mystery']"
The Lovers,2015,35000000,0,53899,53899,-34946101,-648.3626969,-0.998460029,2/13/15,4.7,47,"['Action', 'Adventure', 'Science Fiction', 'Romance']"
The Darkest Hour,2011,34800000,21443494,41388221,62831715,28031715,0.44613958094252243,0.8055090517241379,12/25/11,4.9,735,"['Horror', 'Action', 'Thriller', 'Science Fiction']"
Baby Driver,2017,34000000,107825862,120278323,228104185,194104185,0.850945304,5.708946617647059,6/28/17,7.4,8034,"['Action', 'Crime']"
The Maze Runner,2014,34000000,102427862,245891999,348319861,314319861,0.9023885692237342,9.244701794117647,9/19/14,7.1,10626,"['Action', 'Mystery', 'Science Fiction', 'Thriller']"
The Longest Ride,2015,34000000,37446117,26356811,63802928,29802928,0.4671090956828815,0.8765567058823529,4/10/15,7.5,1908,"['Drama', 'Romance']"
The Darkest Minds,2018,34000000,12695691,25665737,38361428,4361428,0.11369305647328874,0.12827729411764707,8/3/18,6.8,1158,"['Science Fiction', 'Thriller']"
Mike and Dave Need Wedding Dates,2016,33000000,46009673,29888427,75898100,42898100,0.5652065071457651,1.2999424242424242,7/8/16,6,1552,['Comedy']
Step Up Revolution,2012,33000000,35074677,130477613,165552290,132552290,0.8006672091337426,4.0167360606060605,7/27/12,6.8,1252,"['Music', 'Drama', 'Romance']"
Safe,2012,33000000,17142080,24353133,41495213,8495213,0.20472754290958814,0.25743069696969695,4/16/12,6.3,1248,"['Action', 'Crime', 'Thriller']"
Freaks of Nature,2015,33000000,70958,0,70958,-32929042,-464.0638406,-0.997849758,10/30/15,5.8,231,"['Science Fiction', 'Comedy', 'Horror']"
Freaks of Nature,2015,33000000,70958,0,70958,-32929042,-464.0638406,-0.997849758,10/30/15,5.8,231,"['Science Fiction', 'Comedy', 'Horror']"
Bridesmaids,2011,32500000,169211718,120420305,289632023,257132023,0.8877886510498185,7.911754553846154,5/13/11,6.5,2783,"['Comedy', 'Romance']"
The Big Wedding,2013,32500000,21819348,26606623,48425971,15925971,0.3288725176001117,0.4900298769230769,4/25/13,5.8,678,['Comedy']
Wanderlust,2012,32500000,17288155,6871779,24159934,-8340066,-0.34520235,-0.256617415,2/24/12,5.4,693,"['Comedy', 'Romance']"
Takers,2010,32000000,57744720,12842548,70587268,38587268,0.5466604544037602,1.205852125,8/26/10,6.2,605,"['Action', 'Crime', 'Drama', 'Thriller']"
Source Code,2011,32000000,54712227,85716272,140428499,108428499,0.7721260269256314,3.388390594,4/1/11,7.2,4529,"['Thriller', 'Science Fiction', 'Mystery']"
I Feel Pretty,2018,32000000,48795601,42758196,91553797,59553797,0.6504787234548011,1.861056156,4/20/18,6.4,1088,['Comedy']
"Big Mommas: Like Father, Like Son",2011,32000000,37915414,44417036,82332450,50332450,0.6113318624673504,1.572889063,2/18/11,5.5,623,"['Crime', 'Comedy', 'Action']"
1941,1979,32000000,34175000,60700000,94875000,62875000,0.6627140974967062,1.96484375,12/14/79,5.7,262,['Comedy']
The Incredible Burt Wonderstone,2013,32000000,22537881,4854728,27392609,-4607391,-0.168198327,-0.143980969,3/15/13,5.4,920,['Comedy']
Bad Times at the El Royale,2018,32000000,17839115,11365264,29204379,-2795621,-0.09572609,-0.087363156,10/12/18,6.8,1365,"['Thriller', 'Crime', 'Mystery', 'Drama']"
Going the Distance,2010,32000000,17804299,25799691,43603990,11603990,0.2661222057889656,0.362624688,9/3/10,6,394,"['Comedy', 'Drama', 'Romance']"
Repo Men,2010,32000000,13942007,4253231,18195238,-13804762,-0.75870192,-0.431398813,3/19/10,6.2,976,"['Action', 'Science Fiction', 'Thriller', 'Crime']"
Criminal,2016,31500000,14708696,24062566,38771262,7271262,0.1875425669662236,0.23083371428571428,4/15/16,5.9,897,"['Action', 'Crime', 'Science Fiction', 'Thriller', 'Mystery', 'Drama']"
42,2013,31000000,95020213,2450488,97470701,66470701,0.6819557089263162,2.1442161612903226,4/12/13,7,1028,['Drama']
Flight,2012,31000000,93772375,66786063,160558438,129558438,0.8069238815091113,4.179304451612904,11/2/12,6.7,3582,['Drama']
The Grand Budapest Hotel,2014,31000000,59076019,104905242,163981261,132981261,0.8109540089461807,4.289718096774194,3/7/14,8,8091,"['Comedy', 'Drama']"
Vacation,2015,31000000,58884188,43422312,102306500,71306500,0.6969889498712203,2.300209677419355,7/29/15,6.2,1934,['Comedy']
Frequency,2000,31000000,44983704,23095967,68079671,37079671,0.5446511485051095,1.1961184193548386,4/28/00,7.1,791,"['Crime', 'Drama', 'Science Fiction', 'Thriller']"
Extraordinary Measures,2010,31000000,12482741,3344243,15826984,-15173016,-0.958680188,-0.489452129,1/21/10,6.3,153,['Drama']
Birth of the Dragon,2017,31000000,6901965,318525,7220490,-23779510,-3.293337433,-0.767080968,8/25/17,5.7,172,"['Action', 'Drama']"
Toy Story,1995,30000000,191796233,172749283,364545516,334545516,0.9177057495338936,11.1515172,11/22/95,7.9,10174,"['Animation', 'Comedy', 'Family']"
Toy Story,1995,30000000,191796233,172749283,364545516,334545516,0.9177057495338936,11.1515172,11/22/95,7.9,10174,"['Animation', 'Comedy', 'Family']"
Crazy Rich Asians,2018,30000000,174532921,63566790,238099711,208099711,0.8740023670167327,6.936657033333334,8/15/18,7.1,1496,"['Comedy', 'Drama', 'Romance']"
The Vow,2012,30000000,125014030,72604130,197618160,167618160,0.8481920892290465,5.587272,2/10/12,7.1,2409,"['Drama', 'Romance']"
Sisters,2015,30000000,87044645,18986015,106030660,76030660,0.7170629702767105,2.5343553333333335,12/18/15,5.9,922,['Comedy']
Looper,2012,30000000,66486205,103980200,170466405,140466405,0.824012245,4.6822135,9/28/12,6.8,6723,"['Action', 'Thriller', 'Science Fiction']"
Warm Bodies,2013,30000000,66380662,48740946,115121608,85121608,0.7394060027375573,2.8373869333333332,2/1/13,6.3,4109,"['Horror', 'Comedy', 'Romance']"
The Nut Job,2014,30000000,64251538,58278428,122529966,92529966,0.755161933,3.0843322,1/17/14,5.6,529,"['Animation', 'Comedy', 'Family', 'Adventure']"
Hope Springs,2012,30000000,63536011,69549284,133085295,103085295,0.7745806552106301,3.4361765,8/7/12,6.1,429,"['Drama', 'Comedy', 'Romance']"
Midnight in Paris,2011,30000000,56816662,105686112,162502774,132502774,0.8153877668574445,4.416759133333334,5/20/11,7.5,3965,"['Fantasy', 'Comedy', 'Romance']"
Darkest Hour,2017,30000000,56443120,94364052,150807172,120807172,0.8010704689827352,4.026905733333333,11/22/17,7.3,2715,"['Drama', 'History']"
Darkest Hour,2017,30000000,56443120,94364052,150807172,120807172,0.8010704689827352,4.026905733333333,11/22/17,7.3,2715,"['Drama', 'History']"
Life of the Party,2018,30000000,53059911,12700000,65759911,35759911,0.5437950030072273,1.1919970333333334,5/11/18,6.2,435,['Comedy']
Letters to Juliet,2010,30000000,53032453,29116085,82148538,52148538,0.6348078647486094,1.7382846,5/14/10,6.9,1706,"['Comedy', 'Drama', 'Romance']"
Southpaw,2015,30000000,52421953,41734503,94156456,64156456,0.6813813807945363,2.138548533333333,7/24/15,7.4,3424,"['Action', 'Drama']"
Atomic Blonde,2017,30000000,51573925,46771498,98345423,68345423,0.6949527585030572,2.2781807666666665,7/28/17,6.3,3645,"['Action', 'Mystery', 'Thriller']"
Sicario,2015,30000000,46889293,37504456,84393749,54393749,0.6445234350236059,1.8131249666666667,9/18/15,7.3,4475,"['Action', 'Crime', 'Thriller']"
Sicario,2015,30000000,46889293,37504456,84393749,54393749,0.6445234350236059,1.8131249666666667,9/18/15,7.3,4475,"['Action', 'Crime', 'Thriller']"
Den of Thieves,2018,30000000,44947622,35183769,80131391,50131391,0.625614885,1.6710463666666666,1/19/18,6.6,1244,"['Action', 'Thriller', 'Crime']"
The Three Stooges,2012,30000000,44338224,9714025,54052249,24052249,0.4449814659885845,0.8017416333333334,4/13/12,5.1,215,['Comedy']
John Wick,2014,30000000,43037835,33197166,76235001,46235001,0.6064799684333971,1.5411667,10/24/14,7.2,10081,"['Action', 'Thriller']"
The Age of Adaline,2015,30000000,42629776,26354760,68984536,38984536,0.5651199277472853,1.2994845333333334,4/24/15,7.4,3853,"['Fantasy', 'Drama', 'Romance']"
Step Up 3D,2010,30000000,42400223,123488894,165889117,135889117,0.8191563102961118,4.529637233333333,8/6/10,6.7,1160,"['Drama', 'Romance']"
The Cabin in the Woods,2012,30000000,42073277,28616691,70689968,40689968,0.5756116341713438,1.3563322666666666,4/12/12,6.5,4185,"['Horror', 'Comedy', 'Thriller']"
The Cabin in the Woods,2012,30000000,42073277,28616691,70689968,40689968,0.5756116341713438,1.3563322666666666,4/12/12,6.5,4185,"['Horror', 'Comedy', 'Thriller']"
Hanna,2011,30000000,40259119,25084575,65343694,35343694,0.5408891330814569,1.1781231333333333,4/8/11,6.6,1944,"['Action', 'Thriller', 'Adventure']"
The Family,2013,30000000,36918811,14159730,51078541,21078541,0.41266920682013997,0.7026180333333333,9/13/13,6.2,1647,"['Crime', 'Comedy', 'Action']"
The 15:17 to Paris,2018,30000000,36276286,19819914,56096200,26096200,0.4652044166984573,0.8698733333333334,2/9/18,5.3,799,"['Drama', 'History', 'Thriller']"
Larry Crowne,2011,30000000,35608245,25840890,61449135,31449135,0.5117913376648833,1.0483045,6/30/11,5.8,676,"['Comedy', 'Romance', 'Drama']"
Carrie,2013,30000000,35266619,47142901,82409520,52409520,0.6359643885803485,1.746984,10/18/13,5.9,2681,"['Drama', 'Horror']"
Death Wish,2018,30000000,34017028,14558937,48575965,18575965,0.382410622,0.6191988333333334,3/2/18,5.9,1207,"['Action', 'Crime', 'Drama', 'Thriller']"
Entourage,2015,30000000,32363404,14075134,46438538,16438538,0.3539848304440592,0.5479512666666667,6/3/15,6.2,647,['Comedy']
Side Effects,2013,30000000,32172757,34569381,66742138,36742138,0.550508855,1.2247379333333333,2/8/13,6.5,1879,"['Thriller', 'Crime', 'Drama']"
Side Effects,2013,30000000,32172757,34569381,66742138,36742138,0.550508855,1.2247379333333333,10/29/13,7.3,2,"['Music', 'Drama']"
Deliver Us from Evil,2014,30000000,30577122,57379496,87956618,57956618,0.6589227657661871,1.9318872666666667,7/2/14,6.1,1104,"['Thriller', 'Crime', 'Horror']"
Get on Up,2014,30000000,30569935,2769933,33339868,3339868,0.10017640141826596,0.11132893333333334,8/1/14,6.7,251,"['Drama', 'Music']"
The Five-Year Engagement,2012,30000000,28700285,32923534,61623819,31623819,0.5131752545229304,1.0541273,4/27/12,5.8,742,"['Romance', 'Comedy']"
Winnie the Pooh,2011,30000000,26692846,23452761,50145607,20145607,0.4017422104392913,0.6715202333333333,7/14/11,6.9,444,"['Animation', 'Family']"
White Boy Rick,2018,30000000,24004833,1943150,25947983,-4052017,-0.156159228,-0.135067233,9/14/18,6.3,277,"['Crime', 'Drama']"
Sanctum,2011,30000000,23209310,85747788,108957098,78957098,0.7246622702818315,2.631903266666667,2/4/11,5.9,515,"['Action', 'Thriller']"
Ballerina,2017,30000000,21858070,75034759,96892829,66892829,0.6903795635897885,2.2297609666666665,8/25/17,7.2,1024,"['Animation', 'Adventure', 'Comedy', 'Family']"
Ballerina,2017,30000000,21858070,75034759,96892829,66892829,0.6903795635897885,2.2297609666666665,8/25/17,7.2,1024,"['Animation', 'Adventure', 'Comedy', 'Family']"
The Next Three Days,2010,30000000,21148651,46107265,67255916,37255916,0.553942586,1.2418638666666666,11/19/10,7,1469,"['Romance', 'Drama', 'Thriller', 'Crime']"
Proud Mary,2018,30000000,20868638,840901,21709539,-8290461,-0.381881025,-0.2763487,1/12/18,5.5,259,"['Thriller', 'Action', 'Crime']"
Runner Runner,2013,30000000,19316646,41196034,60512680,30512680,0.5042361369550977,1.0170893333333333,10/2/13,5.6,761,"['Crime', 'Thriller', 'Drama']"
Baahubali 2: The Conclusion,2017,30000000,18985794,244517120,263502914,233502914,0.8861492666453017,7.783430466666666,4/27/17,7,252,"['Action', 'Drama']"
Fright Night,2011,30000000,18298649,22222000,40520649,10520649,0.25963673484104366,0.3506883,8/19/11,6,1024,"['Horror', 'Comedy']"
mother!,2017,30000000,17800004,24731072,42531076,12531076,0.2946334111086209,0.41770253333333335,9/15/17,7,3458,"['Drama', 'Horror', 'Mystery']"
Steve Jobs,2015,30000000,17766658,17812349,35579007,5579007,0.15680614695064424,0.1859669,10/9/15,6.8,2572,"['Drama', 'History']"
Steve Jobs,2015,30000000,17766658,17812349,35579007,5579007,0.15680614695064424,0.1859669,10/9/15,6.8,2572,"['Drama', 'History']"
The Last Stand,2013,30000000,12050299,36280458,48330757,18330757,0.37927725816502317,0.6110252333333334,1/12/13,5.9,1692,"['Action', 'Crime', 'Thriller']"
Dead Man Down,2013,30000000,10895295,8704679,19599974,-10400026,-0.530614275,-0.346667533,3/8/13,6,866,"['Thriller', 'Action', 'Crime', 'Drama']"
The Lost City of Z,2017,30000000,8574339,8547484,17121823,-12878177,-0.752149873,-0.429272567,4/21/17,6.2,1397,"['Adventure', 'Drama', 'History']"
The Lost City of Z,2017,30000000,8574339,8547484,17121823,-12878177,-0.752149873,-0.429272567,4/21/17,6.2,1397,"['Adventure', 'Drama', 'History']"
The Space Between Us,2017,30000000,7885294,8596111,16481405,-13518595,-0.820233166,-0.450619833,2/3/17,7.1,1455,"['Romance', 'Adventure', 'Science Fiction', 'Drama']"
Barney's Version,2011,30000000,7502560,1343015,8845575,-21154425,-2.391526272,-0.7051475,1/14/11,7.2,210,"['Comedy', 'Drama']"
Barney's Version,2011,30000000,7502560,1343015,8845575,-21154425,-2.391526272,-0.7051475,1/14/11,7.2,210,"['Comedy', 'Drama']"
Kin,2018,30000000,5718096,4378725,10096821,-19903179,-1.971232232,-0.6634393,8/31/18,6.2,289,"['Science Fiction', 'Action']"
Once Upon a Time in America,1984,30000000,5321508,254140,5575648,-24424352,-4.380540522,-0.814145067,6/1/84,8.4,2243,"['Drama', 'Crime']"
Stronger,2017,30000000,4211129,4575623,8786752,-21213248,-2.414230878,-0.707108267,9/22/17,7,782,['Drama']
Machine Gun Preacher,2011,30000000,538690,3183298,3721988,-26278012,-7.060208684,-0.875933733,9/23/11,6.5,477,"['Action', 'Thriller', 'Crime']"
Bilal: A New Breed of Hero,2018,30000000,490973,157626,648599,-29351401,-45.25354032,-0.978380033,2/2/18,6.8,54,"['Action', 'Adventure', 'Animation']"
Wild Card,2015,30000000,3200,4312589,4315789,-25684211,-5.951220275,-0.856140367,1/30/15,5.5,930,"['Thriller', 'Crime', 'Action']"
United Passions,2015,30000000,918,167914,168832,-29831168,-176.6914329,-0.994372267,6/5/15,3.3,21,['Drama']
Konferenz der Tiere,2010,30000000,0,53048539,53048539,23048539,0.4344801842704848,0.7682846333333333,10/7/10,5.4,151,"['Animation', 'Family', 'Comedy']"
Collide,2017,29200000,2280004,3186694,5466698,-23733302,-4.341432799,-0.812784315,2/24/17,5.6,331,"['Thriller', 'Action']"
Pitch Perfect 2,2015,29000000,184296230,103329238,287625468,258625468,0.8991744361107827,8.918119586206897,5/15/15,6.8,3599,"['Comedy', 'Music']"
Night School,2018,29000000,77339130,25669662,103008792,74008792,0.7184706330698452,2.5520273103448274,9/28/18,6,775,['Comedy']
The Boss,2016,29000000,63077560,15574647,78652207,49652207,0.6312881595299672,1.7121450689655173,4/8/16,5.8,822,['Comedy']
Logan Lucky,2017,29000000,27778642,16485629,44264271,15264271,0.3448440617038514,0.5263541724137931,8/18/17,6.7,1627,"['Action', 'Comedy', 'Crime', 'Drama']"
Florence Foster Jenkins,2016,29000000,27383770,28616569,56000339,27000339,0.4821459920090841,0.9310461724137931,8/12/16,6.7,849,"['Comedy', 'Drama']"
Straight Outta Compton,2015,28000000,161197785,40985196,202182981,174182981,0.8615115878620861,6.22082075,8/14/15,7.7,2048,"['Drama', 'Music']"
Straight Outta Compton,2015,28000000,161197785,40985196,202182981,174182981,0.8615115878620861,6.22082075,8/14/15,7.7,2048,"['Drama', 'Music']"
Girls Trip,2017,28000000,115108515,25777838,140886353,112886353,0.8012582524582775,4.0316554642857145,7/21/17,6.8,968,['Comedy']
A Bad Moms Christmas,2017,28000000,72110659,55599891,127710550,99710550,0.7807542133363297,3.5610910714285713,11/1/17,6.3,1044,['Comedy']
A Bad Moms Christmas,2017,28000000,72110659,55599891,127710550,99710550,0.7807542133363297,3.5610910714285713,11/1/17,6.3,1044,['Comedy']
Safe Haven,2013,28000000,71399120,22651831,94050951,66050951,0.7022890284224771,2.358962535714286,2/14/13,7.1,1433,['Romance']
The Big Short,2015,28000000,70259870,62902882,133162752,105162752,0.7897309902396731,3.7558125714285713,12/11/15,7.3,4657,"['Comedy', 'Drama']"
"Alexander and the Terrible, Horrible, No Good, Very Bad Day",2014,28000000,66954149,34425138,101379287,73379287,0.7238094602105458,2.6206888214285713,10/10/14,6.2,817,"['Family', 'Comedy']"
Last Vegas,2013,28000000,63914167,49000000,112914167,84914167,0.7520240307843745,3.0326488214285714,11/1/13,6.4,1211,['Comedy']
Tag,2018,28000000,54730625,22295561,77026186,49026186,0.6364872590212373,1.7509352142857142,6/15/18,6.8,1297,"['Comedy', 'Drama']"
Kick-Ass,2010,28000000,48071303,49459831,97531134,69531134,0.7129121865844398,2.4832547857142857,4/16/10,7.1,7540,"['Action', 'Crime']"
30 Minutes or Less,2011,28000000,37053924,3912792,40966716,12966716,0.31651831696736443,0.463097,8/12/11,5.6,825,"['Action', 'Adventure', 'Comedy']"
3 Days to Kill,2014,28000000,30697999,8261901,38959900,10959900,0.28131232369692943,0.391425,2/14/14,6.1,1279,"['Action', 'Drama', 'Thriller', 'Crime']"
Kick-Ass 2,2013,28000000,28795985,34333924,63129909,35129909,0.5564701352571251,1.2546396071428572,8/16/13,6.4,3785,"['Action', 'Adventure', 'Crime']"
A Walk Among the Tombstones,2014,28000000,26017685,36090902,62108587,34108587,0.5491766702082596,1.2181638214285715,9/19/14,6.3,1685,"['Crime', 'Drama', 'Mystery', 'Thriller']"
The Spy Next Door,2010,28000000,24307106,22445752,46752858,18752858,0.40110613130859296,0.6697449285714285,1/15/10,5.7,650,"['Action', 'Comedy', 'Family']"
Brick Mansions,2014,28000000,20396829,53024395,73421224,45421224,0.6186388829475248,1.6221865714285715,4/25/14,5.9,909,"['Action', 'Crime', 'Drama']"
American Ultra,2015,28000000,14439985,15855043,30295028,2295028,0.075755929,0.081965286,8/21/15,6,1756,"['Comedy', 'Action']"
Pride and Prejudice and Zombies,2016,28000000,10907291,5731009,16638300,-11361700,-0.682864235,-0.405775,2/5/16,5.7,1195,"['Romance', 'Horror', 'Comedy', 'Thriller']"
Joyful Noise,2012,27500000,30932113,225801,31157914,3657914,0.11739919431063325,0.13301505454545454,1/13/12,6.4,70,"['Comedy', 'Music']"
Anonymous,2011,27500000,4463292,11352217,15815509,-11684491,-0.738799554,-0.424890582,10/28/11,6.4,434,"['Drama', 'History', 'Thriller']"
Limitless,2011,27000000,79249455,76315464,155564919,128564919,0.8264390186838975,4.761663666666666,3/8/11,7.1,6295,"['Thriller', 'Mystery', 'Science Fiction']"
The Blues Brothers,1980,27000000,57229890,0,57229890,30229890,0.5282185585189837,1.1196255555555557,6/17/80,7.7,1972,"['Music', 'Comedy', 'Action', 'Crime']"
Money Monster,2016,27000000,41012075,52454020,93466095,66466095,0.7111251946494609,2.461707222222222,5/13/16,6.4,1859,"['Thriller', 'Drama']"
Spy Kids: All the Time in the World,2011,27000000,38536376,42144807,80681183,53681183,0.6653494780809052,1.988191962962963,8/19/11,4.6,487,"['Family', 'Comedy', 'Action']"
The Magic Flute,2006,27000000,0,0,0,-27000000,#NAME?,-1,12/30/06,9,2,"['Music', 'Comedy', 'Fantasy']"
Pain & Gain,2013,26000000,49875291,31400000,81275291,55275291,0.6800995766351671,2.125972730769231,4/26/13,6.1,2500,"['Thriller', 'Crime', 'Action', 'Comedy']"
Legion,2010,26000000,40168080,27479494,67647574,41647574,0.6156551009501094,1.6018297692307693,1/22/10,5.3,1154,['Horror']
Lawless,2012,26000000,37397291,16996396,54393687,28393687,0.5220033530729402,1.0920648846153846,8/29/12,7,1660,"['Crime', 'Drama']"
The Best of Me,2014,26000000,26766213,14293205,41059418,15059418,0.3667713458578492,0.5792083846153846,10/17/14,7.3,1512,"['Drama', 'Romance']"
The Raven,2012,26000000,16008272,14593529,30601801,4601801,0.15037680298620332,0.17699234615384615,4/27/12,6.3,681,"['Crime', 'Thriller', 'Mystery']"
The Fifth Estate,2013,26000000,3254172,2900000,6154172,-19845828,-3.224776298,-0.763301077,10/18/13,5.9,549,"['Drama', 'Thriller']"
Blood Ties,2014,26000000,42472,2881487,2923959,-23076041,-7.892053548,-0.887540038,3/21/14,6.1,268,"['Thriller', 'Crime', 'Drama']"
Accidental Love,2015,26000000,0,135436,135436,-25864564,-190.9725922,-0.994790923,2/10/15,4,172,"['Romance', 'Comedy']"
The Face of an Angel,2015,26000000,0,0,0,-26000000,#NAME?,-1,3/27/15,5,94,"['Drama', 'Thriller']"
The Help,2011,25000000,169705587,43414417,213120004,188120004,0.8826951973968619,7.52480016,8/10/11,8.1,3944,['Drama']
Hidden Figures,2016,25000000,169607287,62164429,231771716,206771716,0.8921352422484545,8.27086864,12/10/16,8,4710,"['Drama', 'History']"
Hidden Figures,2016,25000000,169607287,62164429,231771716,206771716,0.8921352422484545,8.27086864,12/10/16,8,4710,"['Drama', 'History']"
Ride Along,2014,25000000,134202565,19531235,153733800,128733800,0.8373812395192208,5.149352,1/17/14,6.2,1277,"['Action', 'Comedy']"
Dear John,2010,25000000,80014842,62018667,142033509,117033509,0.8239851977465402,4.68134036,2/4/10,6.8,2676,"['Drama', 'Romance', 'War']"
Parental Guidance,2012,25000000,77267296,43565087,120832383,95832383,0.7931018210573568,3.83329532,12/25/12,5.8,276,['Comedy']
No Strings Attached,2011,25000000,70662220,78565858,149228078,124228078,0.8324712055863911,4.96912312,1/21/11,6.2,2612,"['Comedy', 'Romance']"
Contraband,2012,25000000,66528000,31878855,98406855,73406855,0.745952657,2.9362742,1/13/12,6.2,1114,"['Thriller', 'Action', 'Drama', 'Crime']"
The Lucky One,2012,25000000,60457138,36176695,96633833,71633833,0.7412914377514136,2.86535332,4/20/12,6.9,2012,"['Drama', 'Romance']"
Madea's Big Happy Family,2011,25000000,53345287,815531,54160818,29160818,0.5384116982871271,1.16643272,4/22/11,6.7,71,"['Comedy', 'Drama']"
The Grey,2012,25000000,51580136,29669040,81249176,56249176,0.6923045718026728,2.24996704,1/27/12,6.5,2280,"['Drama', 'Thriller', 'Action', 'Adventure']"
The Grey,2012,25000000,51580136,29669040,81249176,56249176,0.6923045718026728,2.24996704,1/27/12,6.5,2280,"['Drama', 'Thriller', 'Action', 'Adventure']"
The Giver,2014,25000000,45090374,21449831,66540205,41540205,0.6242873011888076,1.6616082,8/11/14,6.5,3075,"['Drama', 'Science Fiction']"
The Night Before,2015,25000000,43035725,9391621,52427346,27427346,0.5231496173771604,1.09709384,11/20/15,6.1,956,['Comedy']
The Night Before,2015,25000000,43035725,9391621,52427346,27427346,0.5231496173771604,1.09709384,11/20/15,6.1,956,['Comedy']
August: Osage County,2013,25000000,37738810,13000000,50738810,25738810,0.507280522,1.0295524,12/27/13,6.9,843,"['Comedy', 'Drama']"
August: Osage County,2013,25000000,37738810,13000000,50738810,25738810,0.507280522,1.0295524,12/27/13,6.9,843,"['Comedy', 'Drama']"
Million Dollar Arm,2014,25000000,36447959,2769953,39217912,14217912,0.3625361798965738,0.56871648,5/16/14,6.8,353,['Drama']
Peppermint,2018,25000000,35418723,16382035,51800758,26800758,0.5173815796286224,1.07203032,9/7/18,6.5,716,"['Thriller', 'Action', 'Drama']"
The Gambler,2014,25000000,33680992,5037039,38718031,13718031,0.3543060079682254,0.54872124,12/25/14,5.8,783,"['Thriller', 'Crime', 'Drama']"
Fist Fight,2017,25000000,32187017,8099399,40286416,15286416,0.37944343324062385,0.61145664,2/17/17,6,708,['Comedy']
The Sitter,2011,25000000,30542576,8206828,38749404,13749404,0.35482878652791666,0.54997616,12/9/11,5.4,472,['Comedy']
Draft Day,2014,25000000,28842237,1005243,29847480,4847480,0.16240835072173598,0.1938992,4/11/14,6.6,460,['Drama']
Rings,2017,25000000,27793018,55124265,82917283,57917283,0.6984947034504254,2.31669132,2/3/17,4.9,1785,['Horror']
The Losers,2010,25000000,23591432,6272408,29863840,4863840,0.16286719993142207,0.1945536,4/23/10,6.2,844,"['Action', 'Adventure', 'Crime', 'Mystery', 'Thriller']"
The Eagle,2011,25000000,19490041,19503507,38993548,13993548,0.3588682927749996,0.55974192,2/11/11,6.1,694,"['Adventure', 'Drama']"
Shark Night 3D,2011,25000000,18877153,0,18877153,-6122847,-0.324352247,-0.24491388,9/2/11,5,245,"['Horror', 'Thriller']"
CHiPS,2017,25000000,18600152,4590140,23190292,-1809708,-0.07803731,-0.07238832,3/24/17,6,657,"['Action', 'Comedy', 'Crime']"
Father Figures,2017,25000000,17501244,3537197,21038441,-3961559,-0.188300977,-0.15846236,12/22/17,5.8,277,['Comedy']
Father Figures,2017,25000000,17501244,3537197,21038441,-3961559,-0.188300977,-0.15846236,12/22/17,5.8,277,['Comedy']
The Counselor,2013,25000000,16973715,54035619,71009334,46009334,0.6479336082774696,1.84037336,10/25/13,5.1,1072,"['Thriller', 'Crime', 'Drama']"
Mary Queen of Scots,2018,25000000,16468499,30266234,46734733,21734733,0.4650659499862768,0.86938932,12/7/18,6.6,592,"['Drama', 'History']"
Legend,1986,25000000,15502112,8004125,23506237,-1493763,-0.063547517,-0.05975052,4/18/86,6.2,509,"['Adventure', 'Fantasy']"
Legend,1986,25000000,15502112,8004125,23506237,-1493763,-0.063547517,-0.05975052,4/18/86,6.2,509,"['Adventure', 'Fantasy']"
Legend,1986,25000000,15502112,8004125,23506237,-1493763,-0.063547517,-0.05975052,4/18/86,6.2,509,"['Adventure', 'Fantasy']"
My Soul to Take,2010,25000000,14744435,1983035,16727470,-8272530,-0.494547591,-0.3309012,10/8/10,5.4,247,"['Drama', 'Horror', 'Mystery', 'Thriller']"
Warrior,2011,25000000,13657115,10558270,24215385,-784615,-0.032401508,-0.0313846,9/9/11,7.8,2189,['Drama']
Battle of the Sexes,2017,25000000,12638526,5806853,18445379,-6554621,-0.355353013,-0.26218484,9/22/17,6.9,1045,"['Comedy', 'Drama', 'History']"
Battle of the Sexes,2017,25000000,12638526,5806853,18445379,-6554621,-0.355353013,-0.26218484,9/22/17,6.9,1045,"['Comedy', 'Drama', 'History']"
Cirque du Soleil: Worlds Away,2012,25000000,12512862,15500000,28012862,3012862,0.10755280913460395,0.12051448,12/21/12,6.8,82,"['Fantasy', 'Family', 'Music', 'Drama']"
The 33,2015,25000000,12227722,16172993,28400715,3400715,0.119740471,0.1360286,11/9/15,6.2,565,"['Drama', 'History']"
The Conspirator,2011,25000000,11538204,4369207,15907411,-9092589,-0.571594523,-0.36370356,4/15/11,6.5,226,"['Crime', 'Drama', 'History']"
Straw Dogs,2011,25000000,10324441,929380,11253821,-13746179,-1.221467713,-0.54984716,9/16/11,5.7,255,"['Drama', 'Thriller']"
Beautiful Boy,2018,25000000,7634767,5396657,13031424,-11968576,-0.918439612,-0.47874304,10/12/18,7.6,500,['Drama']
Sgt. Stubby: An American Hero,2018,25000000,3054285,591672,3645957,-21354043,-5.856910271,-0.85416172,4/13/18,6.4,9,"['Animation', 'Adventure', 'Family', 'History', 'War']"
Carnage,2011,25000000,2546747,35565407,38112154,13112154,0.34404127355278846,0.52448616,12/16/11,7.1,1478,"['Comedy', 'Drama']"
Tulip Fever,2017,25000000,2455635,4337133,6792768,-18207232,-2.680384786,-0.72828928,8/25/17,6.4,307,"['Drama', 'Romance']"
Legend,2015,25000000,1872994,40552456,42425450,17425450,0.41073105883378963,0.697018,11/20/15,6.8,1692,"['Crime', 'Thriller']"
Legend,2015,25000000,1872994,40552456,42425450,17425450,0.41073105883378963,0.697018,11/20/15,6.8,1692,"['Crime', 'Thriller']"
Jane Got a Gun,2016,25000000,1513793,2257552,3771345,-21228655,-5.62893477,-0.8491462,1/29/16,5.5,439,"['Action', 'Drama', 'Western']"
Love Ranch,2010,25000000,137885,8264,146149,-24853851,-170.0583035,-0.99415404,6/30/10,6.1,28,['Drama']
Ironclad,2011,25000000,0,5297411,5297411,-19702589,-3.719286459,-0.78810356,7/8/11,6.1,373,"['Romance', 'Adventure', 'Action', 'History']"
Think Like a Man Too,2014,24000000,65028687,4999246,70027933,46027933,0.6572796172635854,1.9178305416666668,6/20/14,6.3,319,"['Comedy', 'Romance']"
Fences,2016,24000000,57682904,6599977,64282881,40282881,0.6266502118970056,1.678453375,12/16/16,6.8,1465,['Drama']
Fences,2016,24000000,57682904,6599977,64282881,40282881,0.6266502118970056,1.678453375,12/16/16,6.8,1465,['Drama']
Footloose,2011,24000000,51802742,11187092,62989834,38989834,0.6189861367153309,1.6245764166666667,10/14/11,6.6,929,"['Drama', 'Music', 'Romance']"
Going in Style,2017,24000000,45018541,33654038,78672579,54672579,0.694938182,2.278024125,4/7/17,6.6,1324,"['Crime', 'Comedy']"
Piranha 3D,2010,24000000,25003155,58657005,83660160,59660160,0.7131251004062149,2.48584,8/20/10,5.3,1029,"['Comedy', 'Horror']"
Faster,2010,24000000,23240020,12552925,35792945,11792945,0.3294768005259137,0.49137270833333335,11/23/10,6.2,895,"['Crime', 'Drama', 'Action', 'Thriller']"
I Don't Know How She Does It,2011,24000000,9659074,14815389,24474463,474463,0.019386043,0.019769291666666668,9/16/11,5.2,231,"['Romance', 'Comedy']"
Green Book,2018,23000000,85080171,236954268,322034439,299034439,0.9285790672841671,13.001497347826087,11/16/18,8.3,3499,"['Drama', 'Comedy']"
Bad Boys,1995,23000000,65647413,75600000,141247413,118247413,0.8371651592656072,5.141191869565217,4/7/95,6.6,2936,"['Action', 'Comedy', 'Crime', 'Thriller']"
The Wedding Ringer,2015,23000000,64460211,15711385,80171596,57171596,0.7131153532231042,2.4857215652173914,1/16/15,6.5,961,['Comedy']
The Ides of March,2011,23000000,40962534,36773391,77735925,54735925,0.7041265026434046,2.3798228260869565,10/7/11,6.7,1405,['Drama']
The Hate U Give,2018,23000000,29719483,5348182,35067665,12067665,0.3441251363613745,0.5246810869565217,10/19/18,8.2,636,"['Crime', 'Drama']"
Eddie the Eagle,2016,23000000,15789389,29271091,45060480,22060480,0.4895749002229892,0.9591513043478261,2/26/16,7.2,1190,"['Comedy', 'Drama', 'History', 'Adventure']"
Redemption,2013,23000000,36686,13556787,13593473,-9406527,-0.691988501,-0.408979435,4/5/13,5.5,2,['Documentary']
Redemption,2013,23000000,36686,13556787,13593473,-9406527,-0.691988501,-0.408979435,10/11/13,10,2,['History']
Nocturnal Animals,2016,22500000,10663357,21735324,32398681,9898681,0.3055272836570106,0.43994137777777775,11/18/16,7.4,4192,"['Drama', 'Thriller']"
Nocturnal Animals,2016,22500000,10663357,21735324,32398681,9898681,0.3055272836570106,0.43994137777777775,11/18/16,7.4,4192,"['Drama', 'Thriller']"
The Water Diviner,2015,22500000,4200117,26854610,31054727,8554727,0.2754726196755811,0.3802100888888889,4/24/15,6.8,682,"['War', 'Drama']"
Son of God,2014,22000000,59700064,11249729,70949793,48949793,0.6899215759516029,2.224990590909091,2/28/14,6.4,123,['Drama']
The Hundred-Foot Journey,2014,22000000,54235441,40035047,94270488,72270488,0.7666289793683894,3.285022181818182,8/8/14,7.3,785,['Drama']
Diary of a Wimpy Kid: Dog Days,2012,22000000,49008662,28221033,77229695,55229695,0.7151354799471887,2.510440681818182,8/3/12,6.2,440,"['Comedy', 'Family']"
Derailed,2005,22000000,36020063,21500000,57520063,35520063,0.6175247582743434,1.614548318181818,11/11/05,6.2,500,"['Drama', 'Thriller']"
Delivery Man,2013,22000000,30659817,39877053,70536870,48536870,0.6881063761405914,2.2062213636363635,11/22/13,6.2,858,['Comedy']
"Hail, Caesar!",2016,22000000,30080225,34080455,64160680,42160680,0.6571108660319684,1.9163945454545455,2/5/16,5.9,2328,"['Comedy', 'Drama', 'Mystery']"
Diary of a Wimpy Kid: The Long Haul,2017,22000000,20738724,14870853,35609577,13609577,0.3821886735694726,0.6186171363636364,5/19/17,5.6,193,"['Comedy', 'Family']"
Homefront,2013,22000000,20158492,31536870,51695362,29695362,0.574429907,1.3497891818181817,11/27/13,6.5,1410,"['Action', 'Thriller']"
The Transporter Refueled,2015,22000000,16029670,53668825,69698495,47698495,0.6843547339149862,2.168113409090909,9/4/15,5.4,836,"['Thriller', 'Action', 'Crime', 'Mystery']"
Hit & Run,2012,22000000,13749300,3467655,17216955,-4783045,-0.277810159,-0.217411136,8/22/12,5.7,312,"['Action', 'Comedy', 'Romance']"
"Roman J. Israel, Esq.",2017,22000000,11962712,1004300,12967012,-9032988,-0.696612913,-0.410590364,11/17/17,6.2,499,['Drama']
"Roman J. Israel, Esq.",2017,22000000,11962712,1004300,12967012,-9032988,-0.696612913,-0.410590364,11/17/17,6.2,499,['Drama']
Out of the Furnace,2013,22000000,11330849,4103526,15434375,-6565625,-0.425389755,-0.2984375,12/6/13,6.6,1077,"['Thriller', 'Drama', 'Crime']"
Just Getting Started,2017,22000000,6069605,686807,6756412,-15243588,-2.256166143,-0.692890364,12/8/17,4.9,94,"['Action', 'Comedy']"
Just Getting Started,2017,22000000,6069605,686807,6756412,-15243588,-2.256166143,-0.692890364,12/8/17,4.9,94,"['Action', 'Comedy']"
Before I Go to Sleep,2014,22000000,3242457,16321122,19563579,-2436421,-0.124538613,-0.110746409,10/31/14,6.4,1098,"['Mystery', 'Thriller']"
Stone,2010,22000000,1810078,2254942,4065020,-17934980,-4.412027493,-0.815226364,10/22/10,5.2,334,"['Drama', 'Thriller']"
To Rome with Love,2012,21500000,16684352,57641663,74326015,52826015,0.7107338527432151,2.457023953488372,6/22/12,5.7,1097,"['Romance', 'Comedy', 'Drama']"
Silver Linings Playbook,2012,21000000,132092958,104319495,236412453,215412453,0.9111721919318692,10.257735857142857,12/25/12,7.1,7636,"['Drama', 'Comedy', 'Romance']"
Blockers,2018,21000000,60311495,33733833,94045328,73045328,0.7767034211417712,3.4783489523809523,4/6/18,6.1,969,['Comedy']
Death at a Funeral,2010,21000000,42739347,6237886,48977233,27977233,0.5712293505841786,1.3322491904761904,4/15/10,5.7,439,['Comedy']
For Colored Girls,2010,21000000,37729698,288175,38017873,17017873,0.44762822475628766,0.8103749047619048,11/5/10,6.8,33,['Drama']
Kidnap,2017,21000000,30718107,4117973,34836080,13836080,0.3971767202279935,0.6588609523809524,8/4/17,6,805,"['Drama', 'Thriller']"
Tinker Tailor Soldier Spy,2011,21000000,24149393,57303418,81452811,60452811,0.7421820101457272,2.8787052857142856,12/9/11,6.7,1402,"['Drama', 'Thriller', 'Mystery']"
The Beaver,2011,21000000,970816,4075222,5046038,-15953962,-3.161680907,-0.759712476,5/5/11,6.3,464,['Drama']
Bitter Harvest,2017,21000000,557241,48921,606162,-20393838,-33.64420402,-0.971135143,2/24/17,6.2,42,"['War', 'Drama', 'History', 'Romance']"
Close Encounters of the Third Kind,1977,20000000,169100479,171700000,340800479,320800479,0.941314636,16.04002395,11/16/77,7.3,2005,"['Science Fiction', 'Drama']"
La La Land,2016,20000000,151101803,275249360,426351163,406351163,0.9530903120815458,20.31755815,12/9/16,7.9,10028,"['Comedy', 'Drama', 'Romance']"
La La Land,2016,20000000,151101803,275249360,426351163,406351163,0.9530903120815458,20.31755815,12/9/16,7.9,10028,"['Comedy', 'Drama', 'Romance']"
The Conjuring,2013,20000000,137400141,180600000,318000141,298000141,0.9371069461255365,14.90000705,7/19/13,7.5,5912,"['Horror', 'Thriller']"
Wonder,2017,20000000,132422809,172181903,304604712,284604712,0.9343411338955255,14.2302356,11/17/17,8.2,3959,"['Drama', 'Family']"
Wonder,2017,20000000,132422809,172181903,304604712,284604712,0.9343411338955255,14.2302356,11/17/17,8.2,3959,"['Drama', 'Family']"
Jackass 3D,2010,20000000,117229692,54456101,171685793,151685793,0.883508125,7.58428965,10/15/10,6.3,655,"['Comedy', 'Documentary', 'Action']"
Bad Moms,2016,20000000,113257297,67741419,180998716,160998716,0.889501979,8.0499358,7/29/16,6.5,2600,['Comedy']
Tammy,2014,20000000,84525432,11882223,96407655,76407655,0.7925475938606742,3.82038275,7/3/14,5.2,735,['Comedy']
The Descendants,2011,20000000,82624961,92882839,175507800,155507800,0.8860449507087435,7.77539,11/18/11,6.8,1522,"['Comedy', 'Drama']"
The Last Song,2010,20000000,62950384,29728564,92678948,72678948,0.7842012621895535,3.6339474,3/31/10,7.2,2199,"['Drama', 'Family', 'Romance']"
Why Did I Get Married Too?,2010,20000000,60095852,735215,60831067,40831067,0.6712206281043862,2.04155335,4/2/10,5.9,49,"['Comedy', 'Romance']"
12 Years a Slave,2013,20000000,56671993,124353350,181025343,161025343,0.8895182317096894,8.05126715,10/30/13,7.9,6631,"['Drama', 'History']"
Me Before You,2016,20000000,56245075,152020123,208265198,188265198,0.9039685929667424,9.4132599,6/3/16,7.7,5939,"['Drama', 'Romance']"
Barbershop: The Next Cut,2016,20000000,54030051,374151,54404202,34404202,0.6323813370151078,1.7202101,4/15/16,6,248,['Comedy']
A Simple Favor,2018,20000000,53548586,44080131,97628717,77628717,0.7951422428300476,3.88143585,9/14/18,6.6,1756,"['Thriller', 'Crime', 'Mystery', 'Comedy', 'Drama']"
Spotlight,2015,20000000,45055776,47032684,92088460,72088460,0.7828175213267764,3.604423,11/6/15,7.8,4935,"['Drama', 'Thriller', 'History']"
Spotlight,2015,20000000,45055776,47032684,92088460,72088460,0.7828175213267764,3.604423,11/6/15,7.8,4935,"['Drama', 'Thriller', 'History']"
Acrimony,2018,20000000,43549096,3078740,46627836,26627836,0.5710716662896387,1.3313918,3/30/18,6.6,186,"['Drama', 'Thriller']"
Max,2015,20000000,42656255,1001902,43658157,23658157,0.5418954583905133,1.18290785,6/26/15,6.8,407,"['Adventure', 'Drama', 'Family']"
The Star,2017,20000000,40847995,21910015,62758010,42758010,0.6813155802741355,2.1379005,11/17/17,5.4,233,"['Comedy', 'Adventure', 'Family', 'Fantasy', 'Animation']"
Nerve,2016,20000000,38583626,32068658,70652284,50652284,0.7169235179997862,2.5326142,7/27/16,7.1,4590,"['Mystery', 'Adventure', 'Crime']"
Risen,2016,20000000,36880033,9375730,46255763,26255763,0.5676214442727926,1.31278815,2/18/16,5.8,433,"['Drama', 'History']"
Vampires Suck,2010,20000000,36661504,44763484,81424988,61424988,0.7543751556954482,3.0712494,8/18/10,4.1,658,"['Comedy', 'Horror']"
The American,2010,20000000,35606376,32344347,67950723,47950723,0.705669063,2.39753615,9/1/10,5.8,690,"['Crime', 'Drama', 'Thriller']"
Texas Chainsaw 3D,2013,20000000,34341945,13324068,47666013,27666013,0.5804138265140825,1.38330065,1/4/13,5.3,780,"['Horror', 'Thriller']"
She's Out of My League,2010,20000000,32010860,16670117,48680977,28680977,0.5891619019889432,1.43404885,3/12/10,6.1,970,"['Comedy', 'Romance']"
The Debt,2011,20000000,31177548,15426506,46604054,26604054,0.5708527846096823,1.3302027,8/31/11,6.6,403,"['Drama', 'Thriller']"
The World's End,2013,20000000,26004851,21503654,47508505,27508505,0.5790227455063046,1.37542525,8/23/13,6.7,2990,"['Comedy', 'Action', 'Science Fiction']"
From Dusk Till Dawn,1996,20000000,25728961,4025,25732986,5732986,0.22278743710504487,0.2866493,1/19/96,7,3015,"['Horror', 'Action', 'Thriller', 'Crime']"
You Again,2010,20000000,25702053,7136892,32838945,12838945,0.3909670362430949,0.64194725,9/24/10,6.2,734,"['Comedy', 'Romance']"
On the Basis of Sex,2018,20000000,24622687,13450690,38073377,18073377,0.474698554,0.90366885,12/25/18,7.4,225,"['Drama', 'History']"
Endless Love,2014,20000000,23438250,11279923,34718173,14718173,0.42393282042807956,0.73590865,2/14/14,6.8,990,"['Drama', 'Romance']"
Monte Carlo,2011,20000000,23186769,16500000,39686769,19686769,0.49605370999085363,0.98433845,7/1/11,6.2,1193,"['Adventure', 'Comedy', 'Romance']"
Rough Night,2017,20000000,22105643,24738714,46844357,26844357,0.5730542314840611,1.34221785,6/16/17,5.6,1096,"['Drama', 'Comedy']"
Secret in Their Eyes,2015,20000000,20180155,12427864,32608019,12608019,0.3866539393270103,0.63040095,11/20/15,6.3,696,"['Crime', 'Drama', 'Mystery', 'Thriller']"
Secret in Their Eyes,2015,20000000,20180155,12427864,32608019,12608019,0.3866539393270103,0.63040095,11/20/15,6.3,696,"['Crime', 'Drama', 'Mystery', 'Thriller']"
Silent Hill: Revelation 3D,2012,20000000,17530219,38445453,55975672,35975672,0.6427019223637012,1.7987836,10/26/12,5.2,786,"['Thriller', 'Horror', 'Mystery']"
Flatliners,2017,20000000,16883115,28290623,45173738,25173738,0.5572648869571077,1.2586869,9/29/17,5.7,1249,"['Drama', 'Science Fiction']"
Lockout,2012,20000000,14326865,19616184,33943049,13943049,0.4107777412689119,0.69715245,4/13/12,5.9,1004,"['Action', 'Thriller', 'Science Fiction']"
What's Your Number?,2011,20000000,14011084,16152701,30163785,10163785,0.33695323713519376,0.50818925,9/30/11,6.4,1271,"['Comedy', 'Romance']"
Burnt,2015,20000000,13651946,23121564,36773510,16773510,0.4561302415787886,0.8386755,10/23/15,6.4,1841,"['Drama', 'Comedy']"
Burnt,2015,20000000,13651946,23121564,36773510,16773510,0.4561302415787886,0.8386755,10/23/15,6.4,1841,"['Drama', 'Comedy']"
Triple 9,2016,20000000,12639297,13304495,25943792,5943792,0.22910266933993303,0.2971896,2/26/16,5.8,1258,"['Action', 'Thriller', 'Mystery']"
The Light Between Oceans,2016,20000000,12545979,9735753,22281732,2281732,0.10240370901148978,0.1140866,9/2/16,7.1,831,"['Drama', 'Romance']"
Let Me In,2010,20000000,12134935,16135464,28270399,8270399,0.2925462424495671,0.41351995,10/1/10,6.7,1061,"['Drama', 'Horror', 'Mystery']"
Popstar: Never Stop Never Stopping,2016,20000000,9496130,40990,9537120,-10462880,-1.097069136,-0.523144,6/3/16,6.6,675,"['Comedy', 'Music']"
Thank You for Your Service,2017,20000000,9479390,505926,9985316,-10014684,-1.002941119,-0.5007342,10/27/17,6.3,149,"['Drama', 'War']"
Battle of the Year,2013,20000000,8888355,7835022,16723377,-3276623,-0.195930702,-0.16383115,9/21/13,6.1,130,"['Music', 'Drama']"
Machete Kills,2013,20000000,8008161,10264848,18273009,-1726991,-0.094510488,-0.08634955,10/11/13,5.5,1079,"['Action', 'Crime', 'Thriller']"
Little Boy,2015,20000000,6485961,11283338,17769299,-2230701,-0.125536804,-0.11153505,4/23/15,7,292,"['Comedy', 'Drama', 'War']"
Chasing Mavericks,2012,20000000,6002756,2298065,8300821,-11699179,-1.409400227,-0.58495895,10/26/12,7,329,['Drama']
A Most Violent Year,2014,20000000,5749134,3097741,8846875,-11153125,-1.26068527,-0.55765625,12/31/14,6.6,792,"['Crime', 'Drama', 'Thriller']"
A Most Violent Year,2014,20000000,5749134,3097741,8846875,-11153125,-1.26068527,-0.55765625,12/31/14,6.6,792,"['Crime', 'Drama', 'Thriller']"
A Dangerous Method,2011,20000000,5702083,9105448,14807531,-5192469,-0.350664064,-0.25962345,11/23/11,6.3,1066,"['Drama', 'Thriller']"
Hands of Stone,2016,20000000,4712792,319183,5031975,-14968025,-2.974582545,-0.74840125,8/26/16,6.1,167,['Drama']
The Cold Light of Day,2012,20000000,3763583,21597623,25361206,5361206,0.21139396919846792,0.2680603,9/6/12,5.1,463,"['Action', 'Thriller', 'Mystery']"
Suspiria,2018,20000000,2483472,4551143,7034615,-12965385,-1.843083808,-0.64826925,10/26/18,7,752,"['Horror', 'Fantasy']"
LBJ,2017,20000000,2468683,38498,2507181,-17492819,-6.977086616,-0.87464095,11/3/17,6.6,65,['Drama']
Dylan Dog: Dead of Night,2011,20000000,1186538,4907187,6093725,-13906275,-2.282064747,-0.69531375,11/1/11,4.4,243,"['Action', 'Comedy', 'Horror', 'Mystery', 'Science Fiction', 'Thriller']"
All Good Things,2010,20000000,582024,291593,873617,-19126383,-21.8933274,-0.95631915,12/3/10,6,493,"['Drama', 'Mystery', 'Thriller', 'Crime', 'Romance']"
By the Sea,2015,20000000,538460,3189286,3727746,-16272254,-4.365172412,-0.8136127,11/13/15,5.4,306,"['Drama', 'Romance']"
The Tempest,2010,20000000,277943,0,277943,-19722057,-70.95719986,-0.98610285,12/10/10,5.8,52,"['Drama', 'Fantasy']"
Zambezia,2012,20000000,0,34454336,34454336,14454336,0.41952153714412027,0.7227168,7/7/12,5.6,131,"['Comedy', 'Animation', 'Adventure', 'Family']"
Survivor,2015,20000000,0,1703281,1703281,-18296719,-10.74204374,-0.91483595,5/29/15,5.5,581,"['Action', 'Crime', 'Thriller']"
Dwegons and Leprechauns,2014,20000000,0,0,0,-20000000,#NAME?,-1,1/24/14,0.8,2,['Animation']
Fight Valley,2016,20000000,0,0,0,-20000000,#NAME?,-1,7/22/16,3.5,14,"['Action', 'Drama']"
Bird Box,2018,19800000,0,0,0,-19800000,#NAME?,-1,11/12/18,7,4777,"['Thriller', 'Drama']"
The Shape of Water,2017,19500000,63859435,131931359,195790794,176290794,0.9004038974375884,9.040553538461538,12/1/17,7.2,7224,"['Drama', 'Fantasy', 'Romance']"
The Shape of Water,2017,19500000,63859435,131931359,195790794,176290794,0.9004038974375884,9.040553538461538,12/1/17,7.2,7224,"['Drama', 'Fantasy', 'Romance']"
The Frozen Ground,2013,19200000,0,5617460,5617460,-13582540,-2.417914858,-0.707423958,8/23/13,6.3,762,"['Thriller', 'Crime']"
The Devil's Double,2011,19100000,1361512,4604134,5965646,-13134354,-2.201665,-0.687662513,7/29/11,6.7,291,"['Drama', 'Action', 'Thriller', 'Crime', 'War']"
Bad Teacher,2011,19000000,100292856,115156141,215448997,196448997,0.9118120749478356,10.339420894736842,6/19/11,5.5,2894,['Comedy']
Sausage Party,2016,19000000,97670358,43673897,141344255,122344255,0.8655764254443875,6.439171315789474,8/12/16,5.6,4237,"['Adventure', 'Animation', 'Comedy', 'Fantasy']"
The Crazies,2010,19000000,39123589,17321945,56445534,37445534,0.6633923243599751,1.9708175789473685,2/26/10,6.2,1036,"['Mystery', 'Horror', 'Action']"
The Switch,2010,19000000,27758465,22100000,49858465,30858465,0.6189212804686225,1.6241297368421053,8/20/10,6.1,1008,"['Comedy', 'Romance', 'Drama']"
Leap Year,2010,19000000,25918920,6700000,32618920,13618920,0.4175159692595586,0.7167852631578947,1/8/10,6.7,990,"['Romance', 'Comedy']"
The Book Thief,2013,19000000,21488481,54598230,76086711,57086711,0.7502849084907875,3.004563736842105,11/8/13,7.5,2788,['Drama']
Take Me Home Tonight,2011,19000000,6928068,648536,7576604,-11423396,-1.507719817,-0.601231368,3/4/11,6.1,339,"['Comedy', 'Drama', 'Romance']"
Won't Back Down,2012,19000000,5310554,434949,5745503,-13254497,-2.306934136,-0.697605105,9/28/12,6.3,64,['Drama']
Action Point,2018,19000000,5059608,44067,5103675,-13896325,-2.722807585,-0.731385526,6/1/18,5.2,136,"['Comedy', 'Drama']"
Neighbors,2014,18000000,150086800,120857628,270944428,252944428,0.9335657125969757,14.052468222222222,5/9/14,6.2,4536,['Comedy']
Big,1988,18000000,114968774,36700000,151668774,133668774,0.8813203303140038,7.426043,6/3/88,7,1813,"['Fantasy', 'Drama', 'Comedy', 'Romance', 'Family']"
Big,1988,18000000,114968774,36700000,151668774,133668774,0.8813203303140038,7.426043,6/3/88,7,1813,"['Fantasy', 'Drama', 'Comedy', 'Romance', 'Family']"
My Big Fat Greek Wedding 2,2016,18000000,59689605,32406953,92096558,74096558,0.8045529562570622,4.116475444444444,3/25/16,5.8,593,"['Romance', 'Comedy', 'Family']"
The Perfect Guy,2015,18000000,57027435,3250731,60278166,42278166,0.7013844117287842,2.348787,9/11/15,5.7,211,"['Drama', 'Thriller']"
Diary of a Wimpy Kid: Rodrick Rules,2011,18000000,52698535,20996659,73695194,55695194,0.7557506938647858,3.0941774444444445,3/25/11,6.4,492,"['Family', 'Comedy']"
Soul Surfer,2011,18000000,43853424,3305228,47158652,29158652,0.6183097006250305,1.619925111111111,4/8/11,7,688,"['Family', 'Action', 'Drama']"
Uncle Drew,2018,18000000,42469946,4057215,46527161,28527161,0.6131292,1.5848422777777778,6/29/18,6.5,220,['Comedy']
Blue Jasmine,2013,18000000,33404871,69508090,102912961,84912961,0.8250949168589173,4.717386722222222,7/26/13,7,1983,"['Comedy', 'Drama']"
Ricki and the Flash,2015,18000000,26839498,14326535,41166033,23166033,0.5627463059168223,1.2870018333333333,8/7/15,5.8,473,"['Comedy', 'Drama', 'Music']"
Love the Coopers,2015,18000000,26302731,15924759,42227490,24227490,0.573737392,1.3459716666666666,11/13/15,5.8,384,"['Comedy', 'Family', 'Drama']"
The Circle,2017,18000000,20497844,20154020,40651864,22651864,0.5572158757591041,1.2584368888888888,4/28/17,5.5,2689,"['Drama', 'Thriller', 'Science Fiction']"
127 Hours,2010,18000000,18335230,41881941,60217171,42217171,0.7010819389041043,2.345398388888889,11/5/10,7,4469,"['Adventure', 'Drama', 'Thriller']"
Norm of the North,2016,18000000,17062499,13473161,30535660,12535660,0.4105252678343943,0.6964255555555555,1/15/16,4.2,192,"['Adventure', 'Animation', 'Comedy', 'Family']"
Jobs,2013,18000000,16131410,27271105,43402515,25402515,0.585277489,1.4112508333333333,8/16/13,6.1,1622,"['Drama', 'History']"
And So It Goes,2014,18000000,15160801,2759212,17920013,-79987,-0.004463557,-0.004443722,7/25/14,5.9,264,"['Comedy', 'Drama', 'Romance']"
Getaway,2013,18000000,10501938,1312051,11813989,-6186011,-0.523617467,-0.343667278,8/29/13,5.1,380,"['Action', 'Crime']"
Mao's Last Dancer,2010,18000000,4806750,21134687,25941437,7941437,0.30612941758006695,0.44119094444444446,8/20/10,7,45,"['Drama', 'Romance']"
The Railway Man,2014,18000000,4438438,19471772,23910210,5910210,0.24718352536426907,0.328345,4/11/14,6.9,408,"['Drama', 'History']"
Midnight Special,2016,18000000,3712282,3967968,7680250,-10319750,-1.343673709,-0.573319444,3/18/16,6.3,1105,"['Adventure', 'Drama', 'Science Fiction']"
Miss Sloane,2016,18000000,3500605,4219025,7719630,-10280370,-1.331717971,-0.571131667,11/25/16,7.4,912,"['Drama', 'Thriller']"
Miss Sloane,2016,18000000,3500605,4219025,7719630,-10280370,-1.331717971,-0.571131667,11/25/16,7.4,912,"['Drama', 'Thriller']"
Phantom,2013,18000000,1034589,164921,1199510,-16800490,-14.0061275,-0.933360556,3/1/13,6,151,['Thriller']
Carlos,2010,18000000,145526,1473627,1619153,-16380847,-10.11692348,-0.910047056,10/11/10,7,87,"['Crime', 'Drama', 'Thriller', 'History']"
I Am Wrath,2016,18000000,0,309608,309608,-17690392,-57.13803261,-0.982799556,5/13/16,4.9,296,"['Action', 'Crime', 'Drama', 'Thriller']"
Wolves,2014,18000000,0,94953,94953,-17905047,-188.5674702,-0.994724833,11/14/14,5.8,151,"['Horror', 'Action']"
The Prince,2014,18000000,0,0,0,-18000000,#NAME?,-1,8/22/14,4.8,317,"['Thriller', 'Action']"
Forsaken,2016,18000000,0,0,0,-18000000,#NAME?,-1,2/19/16,5.9,161,"['Drama', 'Western']"
Forsaken,2016,18000000,0,0,0,-18000000,#NAME?,-1,2/2/16,3.7,15,['Horror']
Red Lights,2012,17700000,49521,14469363,14518884,-3181116,-0.219101964,-0.179724068,7/12/12,6.1,615,['Thriller']
Black Nativity,2013,17500000,7018188,266947,7285135,-10214865,-1.402151779,-0.583706571,11/27/13,5.7,25,"['Drama', 'Music']"
A Quiet Place,2018,17000000,188024361,146497933,334522294,317522294,0.9491812644331561,18.677782,4/6/18,7.3,5848,"['Drama', 'Horror', 'Thriller', 'Science Fiction']"
The Best Man Holiday,2013,17000000,70525195,2310515,72835710,55835710,0.7665980052916351,3.2844535294117647,11/15/13,6.6,145,['Comedy']
Pitch Perfect,2012,17000000,65001093,51043254,116044347,99044347,0.853504281,5.826138058823529,9/28/12,7.3,4233,"['Comedy', 'Music', 'Romance']"
Evil Dead,2013,17000000,54239856,43538500,97778356,80778356,0.8261373917966058,4.751668,4/5/13,6.4,2664,['Horror']
Saw 3D,2010,17000000,45710178,88025106,133735284,116735284,0.8728832100883713,6.8667814117647055,10/28/10,6,1488,"['Horror', 'Crime']"
"McFarland, USA",2015,17000000,44480275,1227649,45707924,28707924,0.628073242,1.688701411764706,2/20/15,7.3,358,['Drama']
Almost Christmas,2016,17000000,42065185,428321,42493506,25493506,0.5999388706594367,1.499618,11/11/16,5.6,245,"['Comedy', 'Drama']"
Beastly,2011,17000000,27865571,10162659,38028230,21028230,0.5529636798767652,1.236954705882353,3/4/11,6.1,1748,"['Drama', 'Fantasy', 'Romance', 'Science Fiction']"
Tron,1982,17000000,26918576,0,26918576,9918576,0.3684658504966979,0.5834456470588235,7/9/82,6.6,1100,"['Science Fiction', 'Action', 'Adventure']"
Lottery Ticket,2010,17000000,24719879,0,24719879,7719879,0.31229436843117236,0.4541105294117647,8/20/10,5.7,92,['Comedy']
The Apparition,2012,17000000,4936819,5700462,10637281,-6362719,-0.598152761,-0.374277588,8/24/12,4.3,221,"['Horror', 'Thriller']"
L'illusionniste,2010,17000000,2231474,6378475,8609949,-8390051,-0.974460011,-0.493532412,12/25/10,7.4,280,"['Animation', 'Drama']"
Genius,2016,17000000,1361045,5904238,7265283,-9734717,-1.339895087,-0.572630412,6/10/16,6.5,391,"['Drama', 'History']"
"Mune, le gardien de la lune",2017,17000000,0,14534046,14534046,-2465954,-0.169667414,-0.145056118,8/12/17,7,241,"['Animation', 'Family', 'Adventure', 'Fantasy', 'Comedy']"
The Young Messiah,2016,16800000,6469813,843884,7313697,-9486303,-1.297059886,-0.564660893,3/11/16,6.1,50,['Drama']
Moonrise Kingdom,2012,16000000,45512466,23335980,68848446,52848446,0.7676055026717669,3.303027875,5/25/12,7.7,3023,"['Comedy', 'Drama', 'Romance']"
The Artist,2011,16000000,44667095,83589617,128256712,112256712,0.875250194,7.0160445,10/14/11,7.4,1787,"['Drama', 'Comedy', 'Romance']"
The Roommate,2011,16000000,37300107,15245600,52545707,36545707,0.6955031930581884,2.284106688,2/4/11,5.4,406,"['Thriller', 'Drama', 'Horror']"
Remember Me,2010,16000000,19068240,37437880,56506120,40506120,0.7168448302590941,2.5316325,3/12/10,7.1,2079,"['Drama', 'Romance']"
Left Behind,2014,16000000,14019924,6749285,20769209,4769209,0.2296288221665062,0.298075563,10/3/14,4,713,"['Thriller', 'Action', 'Science Fiction']"
People Like Us,2012,16000000,12431792,185680,12617472,-3382528,-0.268082862,-0.211408,6/29/12,6.8,360,['Drama']
Bleed for This,2016,16000000,5083906,1520020,6603926,-9396074,-1.422801225,-0.587254625,11/4/16,6.9,405,['Drama']
Bleed for This,2016,16000000,5083906,1520020,6603926,-9396074,-1.422801225,-0.587254625,11/4/16,6.9,405,['Drama']
The Homesman,2014,16000000,2429989,5787582,8217571,-7782429,-0.94704737,-0.486401813,8/29/14,6.5,389,"['Western', 'Drama']"
Trance,2013,16000000,2322593,20271459,22594052,6594052,0.2918490229198375,0.41212825,4/5/13,6.6,1348,"['Thriller', 'Crime', 'Drama', 'Mystery']"
Enter the Void,2010,16000000,337997,1129281,1467278,-14532722,-9.904545696,-0.908295125,9/24/10,7.3,773,"['Fantasy', 'Drama']"
Vamps,2012,16000000,3361,91451,94812,-15905188,-167.7550099,-0.99407425,11/2/12,5,145,"['Comedy', 'Romance', 'Horror']"
Second Act,2018,15700000,39282227,24006627,63288854,47588854,0.7519310430237842,3.0311371974522294,12/21/18,6.2,361,"['Romance', 'Comedy']"
Beverly Hills Cop,1984,15000000,234760478,81539522,316300000,301300000,0.9525766677205185,20.086666666666666,11/30/84,7.1,1827,"['Action', 'Comedy', 'Crime']"
Annabelle: Creation,2017,15000000,102092201,203292664,305384865,290384865,0.9508816522390525,19.358991,8/11/17,6.5,3141,"['Horror', 'Mystery', 'Thriller']"
Jackass Presents: Bad Grandpa,2013,15000000,102003019,58900000,160903019,145903019,0.9067761432120798,9.726867933333333,10/25/13,6,928,['Comedy']
The Imitation Game,2014,15000000,91125143,136615320,227740463,212740463,0.9341355514852009,14.182697533333334,12/19/14,8.1,10396,"['History', 'Drama', 'Thriller', 'War']"
Mama,2013,15000000,71628180,76467386,148095566,133095566,0.8987140506286326,8.873037733333334,1/18/13,6.1,2421,['Horror']
Diary of a Wimpy Kid,2010,15000000,64003625,12950686,76954311,61954311,0.805079146,4.1302874,3/19/10,6,736,"['Comedy', 'Family']"
The Woman in Black,2012,15000000,54333290,74622608,128955898,113955898,0.8836811636176579,7.597059866666667,2/3/12,6.1,2122,"['Drama', 'Horror', 'Thriller']"
BlacKkKlansman,2018,15000000,49275340,43741995,93017335,78017335,0.8387397359857708,5.201155666666667,7/30/18,7.6,3138,"['Crime', 'Drama']"
Snitch,2013,15000000,42930462,14977272,57907734,42907734,0.7409672428211402,2.8605156,2/22/13,5.9,1493,"['Thriller', 'Drama']"
Krampus,2015,15000000,42725475,19062918,61788393,46788393,0.7572359585399802,3.1192262,12/4/15,6,1046,"['Horror', 'Comedy', 'Fantasy']"
End of Watch,2012,15000000,41003371,16583235,57586606,42586606,0.7395227633314594,2.8391070666666667,9/21/12,7.3,1770,"['Crime', 'Drama', 'Thriller']"
Wild,2014,15000000,37880356,14580187,52460543,37460543,0.7140708208071731,2.4973695333333334,12/5/14,7,1454,['Drama']
The Theory of Everything,2014,15000000,35893537,87434155,123327692,108327692,0.8783728150851959,7.221846133333333,11/26/14,7.9,6412,"['Drama', 'Romance']"
Drive,2011,15000000,35060689,46297241,81357930,66357930,0.8156295274474166,4.423862,9/16/11,7.5,6737,"['Drama', 'Action', 'Thriller', 'Crime']"
The Favourite,2018,15000000,34366783,59747146,94113929,79113929,0.8406187037415046,5.274261933333333,11/23/18,7.7,2096,"['Drama', 'History', 'Comedy']"
When the Game Stands Tall,2014,15000000,30127963,10949,30138912,15138912,0.5023045291084164,1.0092608,8/22/14,6.6,185,['Drama']
Home Again,2017,15000000,27020284,10316590,37336874,22336874,0.5982523871709239,1.4891249333333334,9/8/17,5.9,659,"['Comedy', 'Drama', 'Romance']"
Ramona and Beezus,2010,15000000,26167002,1302619,27469621,12469621,0.4539422294905343,0.8313080666666667,7/23/10,6.3,460,"['Comedy', 'Family']"
The November Man,2014,15000000,25018119,9802216,34820335,19820335,0.5692172404429768,1.3213556666666666,8/27/14,6.1,852,"['Crime', 'Action', 'Thriller']"
The Place Beyond the Pines,2013,15000000,21403519,25607930,47011449,32011449,0.6809287882192272,2.1340966,3/27/13,6.9,2781,"['Drama', 'Crime']"
Keanu,2016,15000000,20591853,96288,20688141,5688141,0.27494693699158373,0.3792094,4/29/16,6,644,"['Action', 'Comedy']"
Country Strong,2010,15000000,20218921,383066,20601987,5601987,0.2719148885978814,0.3734658,12/22/10,6.3,126,"['Drama', 'Romance', 'Music']"
A Most Wanted Man,2014,15000000,17237855,18831035,36068890,21068890,0.5841291484157123,1.4045926666666666,7/25/14,6.5,784,['Thriller']
The Man with the Iron Fists,2012,15000000,15634090,6384898,22018988,7018988,0.31876978179015314,0.46793253333333334,11/2/12,5.3,573,['Action']
Killing Them Softly,2012,15000000,14945541,24292902,39238443,24238443,0.6177218346813609,1.6158962,11/30/12,6,1105,"['Crime', 'Thriller']"
One Day,2011,15000000,13843771,45324921,59168692,44168692,0.7464875512205001,2.9445794666666667,8/19/11,7.2,2105,"['Drama', 'Romance']"
The Founder,2017,15000000,12786053,11617139,24403192,9403192,0.38532631304953874,0.6268794666666667,1/20/17,7,2093,"['Drama', 'History']"
The Founder,2017,15000000,12786053,11617139,24403192,9403192,0.38532631304953874,0.6268794666666667,1/20/17,7,2093,"['Drama', 'History']"
Queen of Katwe,2016,15000000,8874389,1181092,10055481,-4944519,-0.491723767,-0.3296346,9/23/16,7.1,225,['Drama']
Hotel Artemis,2018,15000000,6708137,6050662,12758799,-2241201,-0.175659245,-0.1494134,6/8/18,5.9,471,"['Thriller', 'Science Fiction', 'Action']"
Scouts Guide to the Zombie Apocalypse,2015,15000000,3703046,11851809,15554855,554855,0.035670856,0.036990333,10/30/15,6.2,915,"['Comedy', 'Horror']"
You Will Meet a Tall Dark Stranger,2010,15000000,3247816,31000000,34247816,19247816,0.5620158669387852,1.2831877333333332,5/23/10,5.8,431,"['Comedy', 'Drama', 'Romance']"
Rock the Kasbah,2015,15000000,3020665,365488,3386153,-11613847,-3.429805741,-0.774256467,10/23/15,5.5,154,"['Comedy', 'Music', 'War']"
Rock the Kasbah,2015,15000000,3020665,365488,3386153,-11613847,-3.429805741,-0.774256467,10/23/15,5.5,154,"['Comedy', 'Music', 'War']"
Never Let Me Go,2010,15000000,2434652,8739066,11173718,-3826282,-0.342435884,-0.255085467,9/15/10,6.8,1294,"['Drama', 'Romance', 'Science Fiction']"
The Disappointments Room,2016,15000000,2423467,1080294,3503761,-11496239,-3.281113923,-0.766415933,9/9/16,4.4,272,"['Drama', 'Horror', 'Thriller']"
The Reluctant Fundamentalist,2013,15000000,528731,0,528731,-14471269,-27.36981376,-0.964751267,3/17/13,6.7,120,['Thriller']
Centurion,2010,15000000,123570,7761478,7885048,-7114952,-0.902334647,-0.474330133,2/15/10,6.1,673,"['Adventure', 'Action', 'Drama']"
Winnie Mandela,2013,15000000,61847,0,61847,-14938153,-241.5339952,-0.995876867,9/6/13,5.7,6,['Drama']
The Son of No One,2011,15000000,30680,1117898,1148578,-13851422,-12.05962677,-0.923428133,11/4/11,5.1,156,"['Drama', 'Thriller', 'Crime']"
Khumba,2013,15000000,0,20898221,20898221,5898221,0.2822355548828773,0.39321473333333334,12/7/13,5.6,129,"['Animation', 'Adventure', 'Family']"
In Dubious Battle,2017,15000000,0,214182,214182,-14785818,-69.03389641,-0.9857212,2/17/17,5.9,67,['Drama']
In Dubious Battle,2017,15000000,0,214182,214182,-14785818,-69.03389641,-0.9857212,2/17/17,5.9,67,['Drama']
Broken Horses,2015,15000000,0,3471,3471,-14996529,-4320.521175,-0.9997686,4/10/15,5.4,17,"['Thriller', 'Mystery', 'Drama', 'Crime']"
Magic Mike XXL,2015,14500000,66013057,57647540,123660597,109160597,0.8827435710988845,7.528317034482758,7/1/15,6.2,1110,"['Comedy', 'Drama']"
Elle s'appelait Sarah,2011,14500000,7691700,17788331,25480031,10980031,0.43092690899787367,0.7572435172413793,7/22/11,7.3,408,"['Drama', 'War']"
The Possession,2012,14000000,49130588,33794476,82925064,68925064,0.8311728767553318,4.9232188571428575,8/31/12,5.9,918,"['Horror', 'Thriller']"
Our Family Wedding,2010,14000000,20255281,1155265,21410546,7410546,0.34611662869316834,0.5293247142857143,3/12/10,5.5,57,['Comedy']
Hot Tub Time Machine 2,2015,14000000,12314651,511993,12826644,-1173356,-0.09147802,-0.083811143,2/20/15,5.1,512,['Comedy']
Fun Size,2012,14000000,9409538,1757077,11166615,-2833385,-0.253737144,-0.202384643,10/26/12,5.5,249,['Comedy']
Suffragette,2015,14000000,4702420,29342489,34044909,20044909,0.5887784573017951,1.4317792142857142,10/23/15,7.3,982,"['Drama', 'History']"
Mr. Turner,2014,14000000,3958546,21228480,25187026,11187026,0.44415827418449483,0.7990732857142857,12/19/14,6.5,301,"['History', 'Drama']"
Flipped,2010,14000000,1755212,2534781,4289993,-9710007,-2.263408588,-0.693571929,8/6/10,7.4,859,"['Romance', 'Drama']"
Margaret,2011,14000000,47185,576107,623292,-13376708,-21.46138247,-0.955479143,9/30/11,6.3,138,['Drama']
Seven Psychopaths,2012,13500000,15024049,18011687,33035736,19535736,0.5913516199548271,1.4470915555555555,10/12/12,6.8,2109,"['Comedy', 'Crime']"
The Last Godfather,2011,13400000,164247,0,164247,-13235753,-80.58444294,-0.987742761,4/11/11,4.9,9,"['Action', 'Comedy', 'Thriller']"
Under the Skin,2014,13300000,2614251,4615682,7229933,-6070067,-0.839574447,-0.456396015,4/4/14,6.1,1781,"['Thriller', 'Science Fiction', 'Drama']"
Under the Skin,2014,13300000,2614251,4615682,7229933,-6070067,-0.839574447,-0.456396015,4/4/14,6.1,1781,"['Thriller', 'Science Fiction', 'Drama']"
No Good Deed,2014,13200000,52543632,1779578,54323210,41123210,0.7570099410546616,3.115394696969697,9/12/14,5.8,286,"['Crime', 'Thriller']"
Black Swan,2010,13000000,106954678,224312032,331266710,318266710,0.9607566966206776,24.482054615384616,12/3/10,7.6,8374,"['Drama', 'Thriller']"
Justin Bieber: Never Say Never,2011,13000000,73013910,26020215,99034125,86034125,0.8687321163285887,6.618009615384615,2/11/11,5.1,240,"['Documentary', 'Music', 'Family']"
The First Purge,2018,13000000,69488745,67128560,136617305,123617305,0.9048436799423031,9.509023461538462,7/4/18,5.8,1846,"['Action', 'Science Fiction', 'Thriller', 'Horror']"
Miracles from Heaven,2016,13000000,61705123,12093613,73798736,60798736,0.8238452214140903,4.6768258461538466,3/18/16,7.1,478,['Drama']
The Shallows,2016,13000000,55121623,63641819,118763442,105763442,0.8905387063470256,8.135649384615384,6/24/16,6.3,3037,"['Horror', 'Drama', 'Thriller']"
About Last Night,2014,13000000,48637684,1808176,50445860,37445860,0.7422979804487425,2.880450769230769,2/14/14,6,312,"['Comedy', 'Romance']"
St. Vincent,2014,13000000,44137712,10699522,54837234,41837234,0.7629347971854307,3.2182487692307693,10/31/14,7.1,1069,['Comedy']
Earth to Echo,2014,13000000,38934842,3239703,42174545,29174545,0.6917571961950034,2.2441957692307692,7/2/14,5.7,377,"['Family', 'Adventure', 'Science Fiction']"
Ex Machina,2015,13000000,25440971,12917421,38358392,25358392,0.6610911114313656,1.9506455384615384,4/10/15,7.6,8026,"['Drama', 'Science Fiction']"
Eye in the Sky,2016,13000000,18704596,16698206,35402802,22402802,0.6327974265991715,1.7232924615384615,3/11/16,7.1,850,"['Drama', 'Thriller', 'War']"
Admission,2013,13000000,18007317,726349,18733666,5733666,0.3060621450174248,0.44105123076923075,3/22/13,5.5,385,"['Comedy', 'Drama', 'Romance']"
The Perks of Being a Wallflower,2012,13000000,17742948,15326355,33069303,20069303,0.6068861808185071,1.5437925384615385,9/21/12,7.8,5938,['Drama']
Room,2015,13000000,14677674,21585109,36262783,23262783,0.6415057277870814,1.7894448461538461,10/16/15,8.1,5494,"['Drama', 'Thriller']"
Room,2015,13000000,14677674,21585109,36262783,23262783,0.6415057277870814,1.7894448461538461,10/16/15,8.1,5494,"['Drama', 'Thriller']"
Woodlawn,2015,13000000,14394097,9606,14403703,1403703,0.097454314,0.10797715384615385,10/16/15,7,79,['Drama']
Woodlawn,2015,13000000,14394097,9606,14403703,1403703,0.097454314,0.10797715384615385,10/16/15,7,79,['Drama']
Chloe,2010,13000000,3075255,8755876,11831131,-1168869,-0.098796049,-0.089913,3/26/10,5.9,940,"['Drama', 'Thriller', 'Mystery']"
Youth,2015,13000000,2703296,21298277,24001573,11001573,0.458368833,0.8462748461538462,12/4/15,6.9,1098,"['Comedy', 'Drama']"
The Vatican Tapes,2015,13000000,1784763,13144421,14929184,1929184,0.12922233391992488,0.14839876923076922,7/24/15,4.6,365,"['Thriller', 'Horror']"
Attack the Block,2011,13000000,1024175,5435008,6459183,-6540817,-1.01263844,-0.503139769,7/29/11,6.4,1144,"['Action', 'Comedy', 'Science Fiction']"
The Killer Inside Me,2010,13000000,217277,3400000,3617277,-9382723,-2.593863561,-0.721747923,4/27/10,5.9,304,"['Crime', 'Drama', 'Thriller']"
The Call,2013,12800000,51872378,17949098,69821476,57021476,0.8166753163453606,4.454802813,3/14/13,6.7,1779,"['Crime', 'Thriller']"
The Drop,2014,12600000,10724389,8330145,19054534,6454534,0.3387400605021356,0.5122646031746032,9/12/14,6.7,1215,"['Drama', 'Crime']"
Machete,2010,12500000,26593646,19777324,46370970,33870970,0.7304347957353491,2.7096776,9/3/10,6.3,1862,"['Action', 'Comedy', 'Thriller']"
Conviction,2010,12500000,6797696,5029284,11826980,-673020,-0.056905482,-0.0538416,10/15/10,7.2,297,['Drama']
Casino Jack,2010,12500000,2039869,232317,2272186,-10227814,-4.501310192,-0.81822512,12/17/10,6.1,149,"['Crime', 'Comedy', 'Drama']"
The Perfect Game,2010,12500000,1089445,2841922,3931367,-8568633,-2.17955561,-0.68549064,4/16/10,6.3,44,"['Drama', 'Family']"
The Paperboy,2012,12500000,677200,3350463,4027663,-8472337,-2.103536716,-0.67778696,10/5/12,5.5,409,"['Thriller', 'Drama', 'Mystery']"
The Fault in Our Stars,2014,12000000,124872350,182294484,307166834,295166834,0.9609332822696607,24.597236166666665,5/16/14,7.6,7236,"['Romance', 'Drama']"
American Pie,1999,12000000,101800948,132922200,234723148,222723148,0.9488759412855182,18.560262333333334,7/9/99,6.4,4316,"['Comedy', 'Romance']"
Think Like a Man,2012,12000000,91547205,21826559,113373764,101373764,0.8941554061837446,8.447813666666667,4/20/12,6.9,438,"['Comedy', 'Romance']"
Heaven is for Real,2014,12000000,91386097,9530202,100916299,88916299,0.8810895750348514,7.409691583333333,4/16/14,6.2,363,['Drama']
Act of Valor,2012,12000000,70012847,12484188,82497035,70497035,0.8545402268093635,5.874752916666667,2/24/12,6.3,583,"['Action', 'Thriller', 'War']"
Chronicle,2012,12000000,64575175,59106615,123681790,111681790,0.9029768246400703,9.306815833333333,2/2/12,6.7,3084,"['Science Fiction', 'Drama', 'Thriller']"
Project X,2012,12000000,54731865,48296323,103028188,91028188,0.883527021,7.585682333333334,3/2/12,6.4,2968,"['Comedy', 'Crime']"
"Three Billboards Outside Ebbing, Missouri",2017,12000000,54513740,105678175,160191915,148191915,0.9250898523811267,12.34932625,11/10/17,8.2,5432,"['Crime', 'Drama']"
"Three Billboards Outside Ebbing, Missouri",2017,12000000,54513740,105678175,160191915,148191915,0.9250898523811267,12.34932625,11/10/17,8.2,5432,"['Crime', 'Drama']"
Lion,2016,12000000,51739495,97831225,149570720,137570720,0.9197703935636601,11.464226666666667,11/25/16,8.1,3833,['Drama']
Lion,2016,12000000,51739495,97831225,149570720,137570720,0.9197703935636601,11.464226666666667,11/25/16,8.1,3833,['Drama']
Overboard,2018,12000000,50316123,35053707,85369830,73369830,0.8594351189407312,6.1141525,5/4/18,6.3,535,"['Romance', 'Comedy']"
Philomena,2013,12000000,37709979,61253413,98963392,86963392,0.8787430406589135,7.246949333333333,11/27/13,7.4,945,['Drama']
Paper Towns,2015,12000000,32000304,53450180,85450484,73450484,0.8595677936710107,6.120873666666666,7/24/15,6,3587,"['Drama', 'Mystery', 'Romance']"
Hell or High Water,2016,12000000,27007844,10576460,37584304,25584304,0.68071778,2.1320253333333334,8/12/16,7.3,2468,"['Crime', 'Drama', 'Thriller', 'Western']"
Katy Perry: Part of Me,2012,12000000,25326071,7374368,32700439,20700439,0.6330324495032008,1.7250365833333334,7/5/12,6.8,147,"['Documentary', 'Music']"
Top Five,2014,12000000,25317379,684362,26001741,14001741,0.5384924417176526,1.16681175,12/12/14,6.3,281,"['Drama', 'Comedy']"
Project Almanac,2015,12000000,22348241,10561196,32909437,20909437,0.6353629507548245,1.7424530833333334,1/30/15,6.5,1449,"['Science Fiction', 'Thriller']"
Just Wright,2010,12000000,21540363,327302,21867665,9867665,0.4512445658921517,0.8223054166666667,5/14/10,6.2,211,"['Comedy', 'Drama', 'Romance']"
Nebraska,2013,12000000,17654912,7106448,24761360,12761360,0.5153739536115949,1.0634466666666667,11/15/13,7.4,967,"['Drama', 'Adventure']"
Young Adult,2011,12000000,16311571,6438785,22750356,10750356,0.4725357264739066,0.895863,12/16/11,5.7,603,"['Comedy', 'Drama']"
About Time,2013,12000000,15323921,73985257,89309178,77309178,0.8656353101805505,6.4424315,11/8/13,7.9,3981,"['Comedy', 'Drama', 'Science Fiction']"
If Beale Street Could Talk,2018,12000000,14915773,4943394,19859167,7859167,0.3957450481180807,0.6549305833333333,12/14/18,7.2,388,"['Drama', 'Romance', 'Crime']"
Wish Upon,2017,12000000,14301505,9175840,23477345,11477345,0.4888689500452457,0.9564454166666667,7/14/17,5.4,690,"['Thriller', 'Horror', 'Fantasy']"
Das Boot,1982,12000000,11487676,73482661,84970337,72970337,0.8587742449462099,6.080861416666667,2/10/82,8.1,981,"['Drama', 'History', 'War']"
Das Boot,1982,12000000,11487676,73482661,84970337,72970337,0.8587742449462099,6.080861416666667,2/10/82,8.1,981,"['Drama', 'History', 'War']"
Unforgettable,2017,12000000,11368012,4853199,16221211,4221211,0.2602278584502723,0.35176758333333336,4/21/17,5.5,310,"['Drama', 'Thriller']"
Marshall,2017,12000000,10051659,65157,10116816,-1883184,-0.186143941,-0.156932,10/13/17,7.3,257,['Drama']
Marshall,2017,12000000,10051659,65157,10116816,-1883184,-0.186143941,-0.156932,10/13/17,7.3,257,['Drama']
Arbitrage,2012,12000000,7919574,27911139,35830713,23830713,0.665091789,1.98589275,9/14/12,6.2,459,"['Drama', 'Thriller']"
For Greater Glory: The True Story of Cristiada,2012,12000000,5669081,4357174,10026255,-1973745,-0.19685765,-0.16447875,6/1/12,6.6,63,"['History', 'Drama']"
La grande bellezza,2013,12000000,2883879,26665266,29549145,17549145,0.5938968792498057,1.46242875,11/15/13,7.4,1518,['Drama']
Stoker,2013,12000000,1703125,10331788,12034913,34913,0.002900977,0.002909417,3/1/13,6.6,1282,"['Drama', 'Horror', 'Thriller']"
Kill the Irishman,2011,12000000,1188194,0,1188194,-10811806,-9.099360879,-0.900983833,3/11/11,6.9,274,"['Action', 'Crime', 'Thriller', 'Drama']"
Darling Companion,2012,12000000,793352,406994,1200346,-10799654,-8.997117498,-0.899971167,4/20/12,5,46,"['Drama', 'Romance']"
Trash,2015,12000000,17484,6535702,6553186,-5446814,-0.831170365,-0.453901167,10/9/15,7.1,353,"['Adventure', 'Crime', 'Drama', 'Thriller']"
5 Days of War,2011,12000000,17479,70314,87793,-11912207,-135.6851571,-0.992683917,8/18/11,5.7,102,"['War', 'Drama']"
10 Days in a Madhouse,2015,12000000,14616,0,14616,-11985384,-820.0180624,-0.998782,11/20/15,5.4,7,['Drama']
Triangle,2010,12000000,0,1594955,1594955,-10405045,-6.52372324,-0.867087083,2/2/10,6.8,1094,['Horror']
Drive Hard,2014,12000000,0,0,0,-12000000,#NAME?,-1,10/3/14,4,94,"['Action', 'Comedy', 'Crime']"
Dancin' It's On,2015,12000000,0,0,0,-12000000,#NAME?,-1,10/16/15,4.8,3,"['Drama', 'Romance']"
Carol,2015,11800000,12711491,30132030,42843521,31043521,0.7245791259779979,2.6308068644067797,11/20/15,7.4,1949,"['Romance', 'Drama']"
Carol,2015,11800000,12711491,30132030,42843521,31043521,0.7245791259779979,2.6308068644067797,11/20/15,7.4,1949,"['Romance', 'Drama']"
Dirty Grandpa,2016,11500000,35593113,69485336,105078449,93578449,0.8905579582736323,8.137256434782609,1/22/16,5.8,2667,['Comedy']
The Fighter,2010,11000000,93617009,35645379,129262388,118262388,0.9149017732830373,10.751126181818181,12/17/10,7.3,2325,['Drama']
If I Stay,2014,11000000,50474843,27881327,78356170,67356170,0.8596153946779175,6.1232881818181815,8/22/14,7.4,2703,['Drama']
Brooklyn,2015,11000000,38322743,23753398,62076141,51076141,0.8227982631845623,4.643285545454545,11/4/15,7.3,1912,"['Drama', 'Romance']"
Woman in Gold,2015,11000000,33307793,25278614,58586407,47586407,0.812243137,4.326037,4/10/15,7.4,787,['Drama']
"I, Tonya",2017,11000000,30014534,23782875,53797409,42797409,0.7955291861732597,3.8906735454545456,12/8/17,7.5,2904,['Drama']
"I, Tonya",2017,11000000,30014534,23782875,53797409,42797409,0.7955291861732597,3.8906735454545456,12/8/17,7.5,2904,['Drama']
Quartet,2013,11000000,18388357,37790578,56178935,45178935,0.8041970713755966,4.107175909090909,1/10/13,6.6,209,"['Drama', 'Comedy', 'Romance']"
Inside Llewyn Davis,2013,11000000,13248209,19695038,32943247,21943247,0.6660924164518452,1.9948406363636364,12/6/13,7.2,1400,['Drama']
Peeples,2013,11000000,9177065,130101,9307166,-1692834,-0.181885012,-0.153894,5/9/13,5.2,34,['Comedy']
Brighton Rock,2011,11000000,229653,0,229653,-10770347,-46.89835099,-0.979122455,8/26/11,6,57,"['Drama', 'Thriller', 'Crime']"
LOL,2012,11000000,0,10431506,10431506,-568494,-0.054497788,-0.051681273,5/4/12,6.1,1810,"['Drama', 'Comedy', 'Romance']"
Misconduct,2016,11000000,0,2352511,2352511,-8647489,-3.675854863,-0.786135364,2/5/16,5.5,301,"['Drama', 'Thriller', 'Mystery']"
The Last Days on Mars,2013,10600000,24084,237280,261364,-10338636,-39.55646531,-0.975343019,12/6/13,5.3,407,"['Science Fiction', 'Thriller', 'Horror']"
2001: A Space Odyssey,1968,10500000,59936321,11991725,71928046,61428046,0.8540207807118798,5.850290095238095,4/10/68,8,5837,"['Science Fiction', 'Mystery', 'Adventure']"
Halloween,2018,10000000,159342015,95558652,254900667,244900667,0.9607690316479243,24.4900667,10/19/18,6.4,2020,"['Thriller', 'Horror']"
Good Will Hunting,1997,10000000,138433435,87492554,225925989,215925989,0.9557377172751914,21.5925989,12/5/97,8.1,5764,['Drama']
The Purge: Election Year,2016,10000000,79042440,39472287,118514727,108514727,0.9156223006782946,10.8514727,7/1/16,6.3,2900,"['Action', 'Horror', 'Thriller']"
Book Club,2018,10000000,68566296,22547387,91113683,81113683,0.8902470005520466,8.1113683,5/18/18,6,301,"['Comedy', 'Romance', 'Drama']"
Insidious: The Last Key,2018,10000000,67745330,100140258,167885588,157885588,0.9404356257191058,15.7885588,1/5/18,6.1,1306,"['Mystery', 'Horror', 'Thriller']"
Lady Bird,2017,10000000,48958273,29652496,78610769,68610769,0.8727909658281043,6.8610769,11/3/17,7.3,3866,"['Comedy', 'Drama']"
Lady Bird,2017,10000000,48958273,29652496,78610769,68610769,0.8727909658281043,6.8610769,11/3/17,7.3,3866,"['Comedy', 'Drama']"
The Best Exotic Marigold Hotel,2012,10000000,46383639,88256141,134639780,124639780,0.9257277455444446,12.463978,5/25/12,6.9,756,"['Drama', 'Comedy']"
Hereditary,2018,10000000,44069456,26064449,70133905,60133905,0.8574156108946165,6.0133905,6/8/18,7,2491,"['Horror', 'Mystery', 'Thriller']"
"Love, Simon",2018,10000000,40826341,24694292,65520633,55520633,0.8473763218984773,5.5520633,3/16/18,8.2,3165,"['Comedy', 'Drama', 'Romance']"
Jigsaw,2017,10000000,38052832,64392364,102445196,92445196,0.9023868332488719,9.2445196,10/27/17,6.1,1887,"['Crime', 'Horror', 'Mystery', 'Thriller']"
The Boy,2016,10000000,35819556,32401396,68220952,58220952,0.8534174662352997,5.8220952,1/22/16,5.8,2223,"['Horror', 'Thriller', 'Mystery']"
"Everything, Everything",2017,10000000,34121140,27481996,61603136,51603136,0.8376706017044327,5.1603136,5/19/17,7.2,2447,"['Drama', 'Romance']"
Devil,2010,10000000,33679655,29674459,63354114,53354114,0.8421570539207603,5.3354114,9/17/10,5.9,1516,"['Horror', 'Mystery', 'Thriller']"
The Second Best Exotic Marigold Hotel,2015,10000000,33078266,57306040,90384306,80384306,0.8893613234138237,8.0384306,3/6/15,6.4,420,"['Drama', 'Comedy']"
How to Be a Latin Lover,2017,10000000,32149404,30406824,62556228,52556228,0.8401438142977546,5.2556228,4/28/17,6.3,197,['Comedy']
Slender Man,2018,10000000,30564825,21158819,51723644,41723644,0.80666482,4.1723644,8/10/18,4,712,"['Mystery', 'Thriller', 'Horror']"
When the Bough Breaks,2016,10000000,29747603,1020846,30768449,20768449,0.6749917423526939,2.0768449,9/9/16,5.3,150,"['Mystery', 'Drama', 'Horror']"
Sinister 2,2015,10000000,27740955,26363270,54104225,44104225,0.8151715508354477,4.4104225,8/21/15,5.8,1142,['Horror']
The Forest,2016,10000000,26594261,14154969,40749230,30749230,0.7545965899232943,3.074923,1/8/16,5,957,"['Horror', 'Thriller', 'Mystery']"
The Forest,2016,10000000,26594261,14154969,40749230,30749230,0.7545965899232943,3.074923,3/9/16,5.9,15,"['Drama', 'Horror', 'Fantasy']"
Sparkle,2012,10000000,24397469,262854,24660323,14660323,0.5944903073653982,1.4660323,8/17/12,5.9,53,"['Drama', 'Music']"
Kevin Hart: What Now?,2016,10000000,23591043,0,23591043,13591043,0.5761103059326372,1.3591043,10/14/16,6.5,159,['Comedy']
Mud,2013,10000000,21590086,9966873,31556959,21556959,0.6831126852242004,2.1556959,5/10/13,7,1592,['Drama']
Skyline,2010,10000000,21416355,46848618,68264973,58264973,0.8535119906954333,5.8264973,11/12/10,4.8,833,"['Science Fiction', 'Action']"
The Disaster Artist,2017,10000000,21120616,7597051,28717667,18717667,0.6517822983322427,1.8717667,12/1/17,7.2,1895,"['Comedy', 'Drama']"
The Disaster Artist,2017,10000000,21120616,7597051,28717667,18717667,0.6517822983322427,1.8717667,12/1/17,7.2,1895,"['Comedy', 'Drama']"
Blair Witch,2016,10000000,20777061,18208516,38985577,28985577,0.7434948827357358,2.8985577,9/16/16,5,1094,"['Thriller', 'Horror']"
Blair Witch,2016,10000000,20777061,18208516,38985577,28985577,0.7434948827357358,2.8985577,9/16/16,5,1094,"['Thriller', 'Horror']"
Paranormal Activity: The Ghost Dimension,2015,10000000,18297124,59662250,77959374,67959374,0.8717280618492396,6.7959374,10/23/15,5.2,774,"['Horror', 'Thriller']"
The Birth of a Nation,2016,10000000,15861566,1029445,16891011,6891011,0.40796912630037363,0.6891011,10/7/16,6.5,328,['Drama']
The Birth of a Nation,2016,10000000,15861566,1029445,16891011,6891011,0.40796912630037363,0.6891011,10/7/16,6.5,328,['Drama']
My Week with Marilyn,2011,10000000,14597405,19643167,34240572,24240572,0.7079488041262862,2.4240572,11/23/11,6.7,741,['Drama']
Big Eyes,2014,10000000,14482031,12835841,27317872,17317872,0.6339392760900263,1.7317872,12/25/14,7,2153,['Drama']
Movie 43,2013,10000000,8840453,22324294,31164747,21164747,0.679124621,2.1164747,1/25/13,4.4,1332,['Comedy']
Can You Ever Forgive Me?,2018,10000000,8803865,2948522,11752387,1752387,0.1491090278085635,0.1752387,10/19/18,6.9,450,"['Drama', 'Crime']"
MacGruber,2010,10000000,8525600,104295,8629895,-1370105,-0.15876265,-0.1370105,5/21/10,5.3,270,"['Action', 'Adventure', 'Comedy']"
Bad Words,2014,10000000,7779614,63531,7843145,-2156855,-0.274998741,-0.2156855,3/14/14,6.4,451,['Comedy']
While We're Young,2015,10000000,7582065,9921763,17503828,7503828,0.42869639715381114,0.7503828,4/17/15,5.9,609,"['Comedy', 'Drama', 'Mystery']"
While We're Young,2015,10000000,7582065,9921763,17503828,7503828,0.42869639715381114,0.7503828,4/17/15,5.9,609,"['Comedy', 'Drama', 'Mystery']"
Seeking a Friend for the End of the World,2012,10000000,7078738,4688221,11766959,1766959,0.15016275657967365,0.1766959,6/22/12,6.4,1108,"['Comedy', 'Drama', 'Romance', 'Science Fiction']"
Shut In,2016,10000000,6900335,4460330,11360665,1360665,0.11976983741708783,0.1360665,11/11/16,5.2,374,"['Drama', 'Thriller']"
Cedar Rapids,2011,10000000,6861102,1001029,7862131,-2137869,-0.271919789,-0.2137869,2/11/11,6,206,['Comedy']
The Collection,2012,10000000,6810754,2079340,8890094,-1109906,-0.124847499,-0.1109906,9/21/12,6.1,465,"['Horror', 'Thriller']"
Danny Collins,2015,10000000,5637066,2828779,8465845,-1534155,-0.181216996,-0.1534155,3/20/15,6.7,260,"['Comedy', 'Drama', 'Music']"
Gotti,2018,10000000,4286367,1802733,6089100,-3910900,-0.642278826,-0.39109,6/15/18,5.2,231,"['Crime', 'Drama', 'History', 'Thriller']"
Denial,2016,10000000,4073448,5190492,9263940,-736060,-0.079454314,-0.073606,9/30/16,6.7,349,"['Drama', 'History']"
Denial,2016,10000000,4073448,5190492,9263940,-736060,-0.079454314,-0.073606,9/30/16,6.7,349,"['Drama', 'History']"
The Man Who Knew Infinity,2016,10000000,3877922,8504200,12382122,2382122,0.19238398717118116,0.2382122,4/29/16,7.2,699,['Drama']
Max Steel,2016,10000000,3818664,744416,4563080,-5436920,-1.191502231,-0.543692,10/14/16,5.2,383,"['Action', 'Adventure', 'Science Fiction']"
Max Steel,2016,10000000,3818664,744416,4563080,-5436920,-1.191502231,-0.543692,10/14/16,5.2,383,"['Action', 'Adventure', 'Science Fiction']"
Atlas Shrugged: Part II,2012,10000000,3336053,0,3336053,-6663947,-1.997554295,-0.6663947,10/12/12,5.4,66,"['Drama', 'Science Fiction', 'Mystery']"
Rosewater,2014,10000000,3128941,56776,3185717,-6814283,-2.139010778,-0.6814283,11/7/14,6.7,121,['Drama']
Bucky Larson: Born to Be a Star,2011,10000000,2529395,0,2529395,-7470605,-2.953514576,-0.7470605,9/9/11,4.2,79,['Comedy']
Testament of Youth,2015,10000000,1822250,4824419,6646669,-3353331,-0.504513012,-0.3353331,6/4/15,7.4,486,"['History', 'Drama', 'War']"
Free Fire,2017,10000000,1799322,1994417,3793739,-6206261,-1.635921976,-0.6206261,4/21/17,6.3,540,"['Action', 'Crime', 'Mystery']"
A Better Life,2011,10000000,1759252,124999,1884251,-8115749,-4.30714857,-0.8115749,6/24/11,7.1,97,['Drama']
The Joneses,2010,10000000,1475746,2065819,3541565,-6458435,-1.823610466,-0.6458435,4/16/10,6.2,312,"['Comedy', 'Drama']"
Killer Joe,2012,10000000,1291645,3367465,4659110,-5340890,-1.146332669,-0.534089,7/27/12,6.5,703,"['Crime', 'Drama', 'Thriller']"
Churchill,2017,10000000,1279681,6302515,7582196,-2417804,-0.318879122,-0.2417804,6/2/17,6.1,150,"['Drama', 'Thriller', 'War']"
50 to 1,2014,10000000,1069454,0,1069454,-8930546,-8.350565803,-0.8930546,3/21/14,6.2,25,"['Comedy', 'Drama']"
Coriolanus,2012,10000000,749641,1429982,2179623,-7820377,-3.587949384,-0.7820377,1/19/12,6,215,"['Drama', 'Thriller']"
Parkland,2013,10000000,641439,974914,1616353,-8383647,-5.186767371,-0.8383647,10/4/13,6.1,206,"['History', 'Drama', 'Thriller', 'Mystery']"
Welcome to the Rileys,2010,10000000,152857,203062,355919,-9644081,-27.09628033,-0.9644081,10/29/10,6.5,241,['Drama']
Kicks,2016,10000000,150191,0,150191,-9849809,-65.58188573,-0.9849809,9/9/16,6.6,50,['Adventure']
Blood Done Sign My Name,2010,10000000,109383,0,109383,-9890617,-90.42188457,-0.9890617,2/1/10,6,5,"['Drama', 'Crime']"
Elsa & Fred,2014,10000000,67657,130244,197901,-9802099,-49.53031566,-0.9802099,3/7/14,6.2,48,"['Comedy', 'Family', 'Romance', 'Drama']"
Strangerland,2015,10000000,17472,143625,161097,-9838903,-61.07440238,-0.9838903,7/10/15,5.2,135,"['Drama', 'Thriller', 'Mystery']"
Barbecue,2014,10000000,388,247177,247565,-9752435,-39.39343203,-0.9752435,9/14/14,5.8,383,['Comedy']
The Reef,2010,10000000,0,15037867,15037867,5037867,0.3350120731883052,0.5037867,5/15/10,5.6,264,"['Drama', 'Horror', 'Thriller']"
American Heist,2015,10000000,0,2341218,2341218,-7658782,-3.271281017,-0.7658782,7/14/15,4.6,213,['Action']
Plastic,2014,10000000,0,575371,575371,-9424629,-16.38009041,-0.9424629,9/26/14,6.1,116,"['Drama', 'Action', 'Comedy', 'Crime']"
Into the Grizzly Maze,2015,10000000,0,0,0,-10000000,#NAME?,-1,6/26/15,5.3,121,"['Action', 'Horror', 'Thriller']"
Amour,2012,9700000,6738954,30048090,36787044,27087044,0.7363202109960235,2.792478762886598,12/19/12,7.7,746,"['Drama', 'Romance']"
The Runaways,2010,9500000,3573673,1704959,5278632,-4221368,-0.799708712,-0.444354526,3/19/10,6.4,448,"['Drama', 'Music']"
Melancholia,2011,9400000,3030848,18786450,21817298,12417298,0.5691492136193951,1.3209891489361703,11/11/11,7.1,1642,"['Drama', 'Science Fiction']"
Kites,2010,9200000,1685269,15469924,17155193,7955193,0.4637192365017403,0.8646948913043478,5/21/10,5.8,67,"['Drama', 'Action', 'Romance']"
The Purge: Anarchy,2014,9000000,71562550,39972331,111534881,102534881,0.9193077544952059,11.392764555555555,7/18/14,6.6,3754,"['Horror', 'Thriller']"
Ouija: Origin of Evil,2016,9000000,35144505,46687361,81831866,72831866,0.890018395,8.092429555555556,10/21/16,6,1416,"['Horror', 'Thriller']"
Ouija: Origin of Evil,2016,9000000,35144505,46687361,81831866,72831866,0.890018395,8.092429555555556,10/21/16,6,1416,"['Horror', 'Thriller']"
Black or White,2015,9000000,21571189,399832,21971021,12971021,0.5903695144617995,1.4412245555555556,1/30/15,6.8,193,['Drama']
Black or White,2015,9000000,21571189,399832,21971021,12971021,0.5903695144617995,1.4412245555555556,1/30/15,6.8,193,['Drama']
The Edge of Seventeen,2016,9000000,14431633,4664370,19096003,10096003,0.5286971833843972,1.1217781111111111,11/18/16,7.2,2224,"['Comedy', 'Drama']"
The Edge of Seventeen,2016,9000000,14431633,4664370,19096003,10096003,0.5286971833843972,1.1217781111111111,11/18/16,7.2,2224,"['Comedy', 'Drama']"
Jackie,2016,9000000,13960394,22628118,36588512,27588512,0.7540211528689661,3.0653902222222222,12/2/16,6.4,1420,['Drama']
Loving,2016,9000000,7710234,5187830,12898064,3898064,0.3022208604330076,0.43311822222222224,11/4/16,6.7,529,"['Romance', 'Drama']"
Loving,2016,9000000,7710234,5187830,12898064,3898064,0.3022208604330076,0.43311822222222224,11/4/16,6.7,529,"['Romance', 'Drama']"
The Sapphires,2013,9000000,2450867,17944173,20395040,11395040,0.5587162368889691,1.2661155555555557,3/22/13,6.7,97,"['Comedy', 'Drama']"
Greater,2016,9000000,2000093,0,2000093,-6999907,-3.49979076,-0.777767444,8/26/16,7.3,37,"['Family', 'Drama']"
Destroyer,2018,9000000,1533324,2147772,3681096,-5318904,-1.444924012,-0.590989333,12/25/18,5.9,176,"['Thriller', 'Crime', 'Drama', 'Action']"
Leaves of Grass,2010,9000000,70066,15461,85527,-8914473,-104.2299274,-0.990497,9/17/10,6,214,"['Comedy', 'Crime', 'Thriller']"
Heist,2015,8900000,50136,3273995,3324131,-5575869,-1.677391475,-0.626502135,11/13/15,5.8,498,"['Crime', 'Action', 'Thriller']"
Crocodile Dundee,1986,8800000,174803506,153400000,328203506,319403506,0.9731873674743743,36.29585295454545,9/26/86,6.3,917,"['Adventure', 'Comedy']"
Manchester by the Sea,2016,8500000,47695371,30038496,77733867,69233867,0.8906525517378416,8.145160823529412,11/18/16,7.5,3176,['Drama']
Manchester by the Sea,2016,8500000,47695371,30038496,77733867,69233867,0.8906525517378416,8.145160823529412,11/18/16,7.5,3176,['Drama']
The DUFF,2015,8500000,34030343,9498291,43528634,35028634,0.8047262406626406,4.1210157647058825,2/20/15,6.8,2987,"['Romance', 'Comedy']"
Nightcrawler,2014,8500000,32381218,17953200,50334418,41834418,0.8311294669186401,4.921696235294117,10/31/14,7.7,5860,"['Crime', 'Drama', 'Thriller']"
Baggage Claim,2013,8500000,21569509,1316327,22885836,14385836,0.6285912387032748,1.692451294117647,9/27/13,5.4,127,['Comedy']
Middle School: The Worst Years of My Life,2016,8500000,20007149,3304144,23311293,14811293,0.6353698612942663,1.7425050588235294,10/7/16,7,190,"['Family', 'Comedy']"
The Rover,2014,8500000,1109199,2071053,3180252,-5319748,-1.672744172,-0.625852706,7/18/14,6.2,435,"['Crime', 'Drama']"
Easy A,2010,8000000,58401464,17799257,76200721,68200721,0.8950141167299454,8.525090125,9/17/10,6.8,4168,['Comedy']
50/50,2011,8000000,35016118,6318617,41334735,33334735,0.8064581761562037,4.166841875,9/30/11,7.1,2111,"['Comedy', 'Drama']"
A Walk in the Woods,2015,8000000,29499394,7619964,37119358,29119358,0.7844790311297949,3.63991975,9/2/15,5.9,402,"['Adventure', 'Comedy', 'Drama']"
Howards End,1992,8000000,26124872,193071,26317943,18317943,0.6960248755003383,2.289742875,3/13/92,7.2,201,"['Drama', 'Romance']"
That Awkward Moment,2014,8000000,26068955,27000000,53068955,45068955,0.8492527316582736,5.633619375,1/31/14,6.1,1759,"['Comedy', 'Romance']"
Enough Said,2013,8000000,17550872,8070577,25621449,17621449,0.6877616094234171,2.202681125,9/18/13,6.7,464,"['Comedy', 'Drama', 'Romance']"
Begin Again,2014,8000000,16170632,52668104,68838736,60838736,0.8837863612138375,7.604842,7/11/14,7.2,2089,"['Comedy', 'Music', 'Romance', 'Drama']"
Prom,2011,8000000,10130219,632964,10763183,2763183,0.2567254500829355,0.345397875,4/29/11,6,276,"['Comedy', 'Romance']"
Me and Earl and the Dying Girl,2015,8000000,6758416,2507764,9266180,1266180,0.13664530583260848,0.1582725,6/12/15,7.6,1570,"['Comedy', 'Drama']"
It's Kind of a Funny Story,2010,8000000,6363628,269322,6632950,-1367050,-0.20609985,-0.17088125,10/8/10,7,1324,"['Comedy', 'Drama']"
Morgan,2016,8000000,3915251,3383535,7298786,-701214,-0.096072689,-0.08765175,9/2/16,5.7,843,"['Horror', 'Science Fiction', 'Thriller']"
Anomalisa,2015,8000000,3759286,1946882,5706168,-2293832,-0.401991669,-0.286729,12/30/15,7.1,927,"['Animation', 'Comedy', 'Drama', 'Romance']"
Anomalisa,2015,8000000,3759286,1946882,5706168,-2293832,-0.401991669,-0.286729,12/30/15,7.1,927,"['Animation', 'Comedy', 'Drama', 'Romance']"
Another Year,2010,8000000,3205706,16799907,20005613,12005613,0.6001122285030707,1.500701625,12/29/10,7,150,"['Comedy', 'Drama']"
Lean on Pete,2018,8000000,1163056,1291971,2455027,-5544973,-2.258619966,-0.693121625,4/6/18,6.9,133,"['Drama', 'Adventure']"
Lean on Pete,2018,8000000,1163056,1291971,2455027,-5544973,-2.258619966,-0.693121625,4/6/18,6.9,133,"['Drama', 'Adventure']"
Made in Dagenham,2010,8000000,1095369,14548827,15644196,7644196,0.4886282427041952,0.9555245,11/19/10,6.6,150,"['Comedy', 'Drama', 'History']"
El Chicano,2019,8000000,700261,0,700261,-7299739,-10.42431179,-0.912467375,5/3/19,9,1,"['Drama', 'Action', 'Crime']"
London Fields,2018,8000000,252676,181056,433732,-7566268,-17.44456946,-0.9457835,10/26/18,5.3,59,"['Crime', 'Mystery', 'Thriller', 'Drama']"
Restless,2011,8000000,163753,2608758,2772511,-5227489,-1.885470968,-0.653436125,9/16/11,6.4,258,"['Drama', 'Romance']"
Wild Target,2010,8000000,109338,5204856,5314194,-2685806,-0.505402324,-0.33572575,10/29/10,6.4,356,"['Action', 'Comedy']"
Wuthering Heights,2012,8000000,100915,2620619,2721534,-5278466,-1.939518669,-0.65980825,4/9/12,6.1,115,"['Drama', 'Romance']"
A Street Cat Named Bob,2016,8000000,82703,17299990,17382693,9382693,0.5397721170131694,1.172836625,11/18/16,7.5,500,"['Drama', 'Family', 'Comedy']"
A Street Cat Named Bob,2016,8000000,82703,17299990,17382693,9382693,0.5397721170131694,1.172836625,11/18/16,7.5,500,"['Drama', 'Family', 'Comedy']"
Aloft,2015,8000000,53086,184602,237688,-7762312,-32.6575679,-0.970289,5/22/15,5.5,61,['Drama']
Fireflies in the Garden,2011,8000000,36884,3550307,3587191,-4412809,-1.230157246,-0.551601125,10/11/11,6.3,96,['Drama']
Swelter,2014,8000000,0,44197,44197,-7955803,-180.0077607,-0.994475375,4/20/14,5.1,44,"['Action', 'Drama', 'Thriller']"
Code of Honor,2016,8000000,0,0,0,-8000000,#NAME?,-1,5/6/16,4.2,36,"['Action', 'Crime', 'Thriller']"
Loin des hommes,2015,7700000,5336,1075092,1080428,-6619572,-6.126805303,-0.859684675,5/1/15,6.9,64,"['Drama', 'War']"
Albert Nobbs,2011,7500000,3014696,5524307,8539003,1039003,0.12167731994004452,0.13853373333333333,12/21/11,6.3,227,['Drama']
The Neon Demon,2016,7500000,1333124,2226679,3559803,-3940197,-1.10685816,-0.5253596,6/14/16,6.6,2005,"['Thriller', 'Horror', 'Mystery']"
Pound of Flesh,2015,7500000,0,0,0,-7500000,#NAME?,-1,5/7/15,5.4,95,['Action']
The Bye Bye Man,2017,7400000,22395806,8791921,31187727,23787727,0.7627271779055909,3.214557702702703,1/13/17,5.1,678,"['Horror', 'Thriller']"
Harry Brown,2010,7300000,1818681,10204925,12023606,4723606,0.39286101024933784,0.6470693150684932,4/30/10,6.8,505,"['Thriller', 'Crime', 'Drama', 'Action']"
Magic Mike,2012,7000000,113721571,56828182,170549753,163549753,0.9589562583535375,23.364250428571427,6/29/12,6.1,1850,"['Drama', 'Comedy']"
I Can Only Imagine,2018,7000000,83482352,2121869,85604221,78604221,0.9182283312875424,11.22917442857143,3/16/18,7.6,155,"['Drama', 'Family', 'Music']"
Jumping the Broom,2011,7000000,37295394,863207,38158601,31158601,0.8165551195128983,4.4512287142857145,5/6/11,6,103,['Comedy']
Desperado,1995,7000000,25532388,0,25532388,18532388,0.7258384135475303,2.647484,8/25/95,6.8,1440,"['Thriller', 'Action', 'Crime']"
Gifted,2017,7000000,24801212,12163444,36964656,29964656,0.810629916,4.280665142857143,4/12/17,7.9,2035,"['Drama', 'Family', 'Comedy']"
Action Jackson,1988,7000000,20257000,0,20257000,13257000,0.6544404403416103,1.893857142857143,2/12/88,5.2,81,"['Action', 'Adventure', 'Comedy', 'Crime', 'Drama']"
Dope,2015,7000000,17506470,684361,18190831,11190831,0.6151907518683452,1.598690142857143,6/19/15,7.2,954,"['Crime', 'Drama', 'Comedy']"
Devil's Due,2014,7000000,15821461,20324626,36146087,29146087,0.8063414167071529,4.163726714285715,1/17/14,4.5,303,['Horror']
Beyond the Lights,2014,7000000,14618727,0,14618727,7618727,0.5211621367578723,1.0883895714285714,11/14/14,7,238,"['Romance', 'Drama']"
Beyond the Lights,2014,7000000,14618727,0,14618727,7618727,0.5211621367578723,1.0883895714285714,11/14/14,7,238,"['Romance', 'Drama']"
Get Low,2010,7000000,9176933,1651372,10828305,3828305,0.3535460997820065,0.5469007142857143,1/22/10,6.7,135,"['Comedy', 'Drama', 'Mystery']"
Cyrus,2010,7000000,7468936,2593960,10062896,3062896,0.3043752017311915,0.4375565714285714,6/18/10,6,201,"['Comedy', 'Drama', 'Romance']"
Somewhere,2010,7000000,1785645,15237476,17023121,10023121,0.5887945577077199,1.4318744285714287,12/22/10,6.1,376,"['Comedy', 'Drama']"
The Christmas Candle,2013,7000000,1632000,301829,1933829,-5066171,-2.619761623,-0.723738714,11/22/13,6,15,"['Drama', 'Family']"
Freeheld,2015,7000000,546201,1186027,1732228,-5267772,-3.041038478,-0.752538857,10/2/15,7.3,360,"['Romance', 'Drama']"
Dom Hemingway,2014,7000000,523511,1333947,1857458,-5142542,-2.768591268,-0.734648857,4/3/14,5.8,302,"['Comedy', 'Crime', 'Drama']"
The Extra Man,2010,7000000,453377,38731,492108,-6507892,-13.22451982,-0.929698857,8/1/10,5.9,46,['Comedy']
Ca$h,2010,7000000,46488,0,46488,-6953512,-149.5764929,-0.993358857,1/1/10,5.8,112,"['Crime', 'Thriller', 'Comedy', 'Mystery']"
Criminal Activities,2015,7000000,0,386744,386744,-6613256,-17.09982831,-0.944750857,11/20/15,5.9,166,"['Thriller', 'Crime', 'Drama']"
Criminal Activities,2015,7000000,0,386744,386744,-6613256,-17.09982831,-0.944750857,11/20/15,5.9,166,"['Thriller', 'Crime', 'Drama']"
House at the End of the Street,2012,6900000,31611916,12492066,44103982,37203982,0.8435515414458495,5.391881449275362,9/21/12,5.8,1033,"['Horror', 'Thriller']"
Incendies,2010,6800000,6857096,9181247,16038343,9238343,0.5760160510346986,1.3585798529411766,9/4/10,8.1,1034,"['Drama', 'War', 'Mystery']"
Annabelle,2014,6500000,84273813,172589107,256862920,250362920,0.9746946737193519,38.517372307692305,10/3/14,5.6,3357,['Horror']
Dressed to Kill,1980,6500000,31899000,0,31899000,25399000,0.7962318567980188,3.9075384615384614,6/25/80,6.8,300,"['Mystery', 'Thriller']"
Same Kind of Different as Me,2017,6500000,6423605,0,6423605,-76395,-0.011892855,-0.011753077,10/20/17,6.8,103,['Drama']
Same Kind of Different as Me,2017,6500000,6423605,0,6423605,-76395,-0.011892855,-0.011753077,10/20/17,6.8,103,['Drama']
Shame,2011,6500000,4002293,16410548,20412841,13912841,0.6815729863373746,2.1404370769230767,12/2/11,7,1607,['Drama']
The East,2013,6500000,2274649,753307,3027956,-3472044,-1.146662633,-0.534160615,5/31/13,6.6,438,"['Drama', 'Thriller']"
Breaking In,2018,6000000,46840590,4571030,51411620,45411620,0.8832948660244513,7.568603333333333,5/13/18,5.9,290,"['Thriller', 'Crime', 'Action']"
The Possession of Hannah Grace,2018,6000000,14836174,27949213,42785387,36785387,0.8597652044143016,6.130897833333333,11/30/18,5.1,393,"['Horror', 'Drama']"
The Words,2012,6000000,11494838,4874870,16369708,10369708,0.6334693325012273,1.7282846666666667,9/7/12,6.6,628,"['Drama', 'Thriller']"
Bernie,2012,6000000,9204489,902486,10106975,4106975,0.40635056483270215,0.6844958333333333,4/27/12,6.6,503,"['Comedy', 'Crime', 'Drama']"
Bernie,2012,6000000,9204489,902486,10106975,4106975,0.40635056483270215,0.6844958333333333,4/27/12,6.6,503,"['Comedy', 'Crime', 'Drama']"
The Guard,2011,6000000,5359774,15837680,21197454,15197454,0.716947139,2.532909,7/29/11,6.9,563,"['Action', 'Comedy', 'Thriller', 'Crime']"
Wish I Was Here,2014,6000000,3591299,3000066,6591365,591365,0.089718139,0.098560833,1/18/14,6.6,440,"['Drama', 'Comedy']"
Veronica Mars,2014,6000000,3322127,163256,3485383,-2514617,-0.721475086,-0.419102833,3/14/14,6.7,699,"['Comedy', 'Drama', 'Crime']"
Snow Flower and the Secret Fan,2011,6000000,1348205,10000000,11348205,5348205,0.47128202213477816,0.8913675,7/15/11,5.9,39,"['Drama', 'History']"
Mandy,2018,6000000,1214525,213131,1427656,-4572344,-3.202693086,-0.762057333,9/13/18,6.2,618,"['Action', 'Thriller', 'Horror', 'Fantasy', 'Mystery']"
The 5th Quarter,2011,6000000,408159,0,408159,-5591841,-13.70015362,-0.9319735,3/25/11,4.7,15,['Drama']
The 5th Quarter,2011,6000000,408159,0,408159,-5591841,-13.70015362,-0.9319735,3/25/11,4.7,15,['Drama']
Deadfall,2012,6000000,66351,1607284,1673635,-4326365,-2.585011069,-0.721060833,12/7/12,5.9,357,"['Crime', 'Drama', 'Thriller']"
Song One,2015,6000000,32251,404838,437089,-5562911,-12.72718142,-0.927151833,1/23/15,5.6,126,['Drama']
Song One,2015,6000000,32251,404838,437089,-5562911,-12.72718142,-0.927151833,1/23/15,5.6,126,['Drama']
Icarus,2010,6000000,0,0,0,-6000000,#NAME?,-1,9/10/10,5.2,42,"['Action', 'Drama', 'Thriller']"
The Hit List,2011,6000000,0,0,0,-6000000,#NAME?,-1,4/3/11,5.4,116,"['Action', 'Thriller']"
Valhalla Rising,2010,5700000,30638,700975,731613,-4968387,-6.79100426,-0.871646842,7/16/10,6,582,"['Adventure', 'Drama', 'Action', 'Fantasy']"
Standing Ovation,2010,5600000,531806,0,531806,-5068194,-9.530155733,-0.905034643,7/16/10,4.3,12,"['Comedy', 'Music', 'Family']"
Khiladi 786,2012,5600000,385422,14298341,14683763,9083763,0.6186263698208695,1.6221005357142857,12/7/12,4.7,16,"['Action', 'Comedy']"
Don Jon,2013,5500000,24477704,16790875,41268579,35768579,0.8667266929641556,6.503378,9/27/13,5.9,2709,"['Romance', 'Comedy', 'Drama']"
Hell Fest,2018,5500000,11107431,7011800,18119231,12619231,0.6964551089392259,2.2944056363636363,9/28/18,5.5,273,['Horror']
Le Havre,2011,5500000,611709,12868487,13480196,7980196,0.5919940629943363,1.4509447272727272,10/21/11,6.9,169,"['Drama', 'Comedy']"
Salvation Boulevard,2011,5500000,28468,0,28468,-5471532,-192.1993818,-0.994824,7/15/11,5.4,38,"['Comedy', 'Thriller', 'Action', 'Drama']"
Grabbers,2013,5300000,0,440821,440821,-4859179,-11.02302068,-0.916826226,7/19/13,6.1,202,"['Science Fiction', 'Comedy', 'Thriller', 'Horror', 'Mystery']"
Get Out,2017,5000000,176040665,79327286,255367951,250367951,0.9804204091374019,50.0735902,2/24/17,7.5,8760,"['Mystery', 'Thriller', 'Horror']"
Paranormal Activity 3,2011,5000000,104028807,103011037,207039844,202039844,0.9758500590833135,40.4079688,10/21/11,5.9,1197,['Horror']
10 Cloverfield Lane,2016,5000000,72082999,36203423,108286422,103286422,0.9538261592944681,20.6572844,3/11/16,6.9,4629,"['Thriller', 'Science Fiction', 'Drama']"
Lights Out,2016,5000000,67268835,81537675,148806510,143806510,0.9663993194921379,28.761302,7/22/16,6.3,2220,"['Thriller', 'Mystery', 'Horror']"
The Visit,2015,5000000,65206105,33471711,98677816,93677816,0.9493300500286711,18.7355632,9/11/15,6.2,2634,"['Horror', 'Thriller', 'Mystery']"
The Visit,2015,5000000,65206105,33471711,98677816,93677816,0.9493300500286711,18.7355632,1/26/15,6,12,['Documentary']
The Visit,2015,5000000,65206105,33471711,98677816,93677816,0.9493300500286711,18.7355632,5/1/15,8,1,[None]
Happy Death Day,2017,5000000,55683845,69326415,125010260,120010260,0.960003283,24.002052,10/13/17,6.6,3211,"['Horror', 'Mystery', 'Thriller']"
Paranormal Activity 4,2012,5000000,53900335,88917657,142817992,137817992,0.9649904054105451,27.5635984,10/19/12,5.4,1026,['Horror']
Ouija,2014,5000000,50856010,52444622,103300632,98300632,0.9515975855791473,19.6601264,10/24/14,5.1,1670,['Horror']
No se Aceptan Devoluciones,2013,5000000,44467206,56019410,100486616,95486616,0.9502421297578575,19.0973232,8/30/13,7.6,339,"['Comedy', 'Drama']"
The Gift,2015,5000000,43787265,15191212,58978477,53978477,0.9152233110393814,10.7956954,8/7/15,6.7,1797,"['Thriller', 'Mystery']"
The Gift,2015,5000000,43787265,15191212,58978477,53978477,0.9152233110393814,10.7956954,6/19/15,9,1,['Drama']
The Big Sick,2017,5000000,42872467,11100393,53972860,48972860,0.9073608476556551,9.794572,6/23/17,7.4,1302,"['Comedy', 'Drama', 'Romance']"
Paranormal Activity: The Marked Ones,2014,5000000,32462372,58442482,90904854,85904854,0.9449974365505279,17.1809708,1/3/14,5.3,752,"['Horror', 'Thriller']"
Oculus,2014,5000000,27695246,16420250,44115496,39115496,0.8866611405661177,7.8230992,4/3/14,6.4,1747,['Horror']
Dallas Buyers Club,2013,5000000,27298285,33313560,60611845,55611845,0.9175078732548069,11.122369,11/22/13,7.9,4961,"['Drama', 'History']"
Dallas Buyers Club,2013,5000000,27298285,33313560,60611845,55611845,0.9175078732548069,11.122369,11/22/13,7.9,4961,"['Drama', 'History']"
No Escape,2015,5000000,27288872,15555644,42844516,37844516,0.8832989500920024,7.5689032,8/26/15,6.8,1296,"['Action', 'Thriller']"
The Lazarus Effect,2015,5000000,25801570,12557740,38359310,33359310,0.8696535469485766,6.671862,2/27/15,5.1,825,"['Thriller', 'Horror']"
Our Idiot Brother,2011,5000000,24814830,1046419,25861249,20861249,0.8066605367745386,4.1722498,8/26/11,6.1,527,"['Comedy', 'Drama']"
The Strangers: Prey at Night,2018,5000000,24431472,5528579,29960051,24960051,0.8331110985091448,4.9920102,3/9/18,5.4,621,"['Horror', 'Thriller']"
The Way Way Back,2013,5000000,21502690,5351120,26853810,21853810,0.8138066814355207,4.370762,7/5/13,7.1,1043,"['Comedy', 'Drama']"
"As Above, So Below",2014,5000000,21222315,20601751,41824066,36824066,0.880451604,7.3648132,8/29/14,6.2,1321,"['Horror', 'Thriller']"
Race,2016,5000000,19115191,4630581,23745772,18745772,0.7894361994211011,3.7491544,2/19/16,7.2,910,"['Action', 'Drama']"
Apollo 18,2011,5000000,17686929,8830890,26517819,21517819,0.8114475402370006,4.3035638,9/2/11,5,486,"['Horror', 'Thriller', 'Science Fiction']"
"Paul, Apostle of Christ",2018,5000000,17547999,7981499,25529498,20529498,0.8041481270019489,4.1058996,3/28/18,7.1,98,['History']
Addicted,2014,5000000,17390770,108472,17499242,12499242,0.7142733382394506,2.4998484,10/10/14,5.3,103,"['Drama', 'Thriller']"
Spring Breakers,2013,5000000,14124286,17024965,31149251,26149251,0.8394824967059401,5.2298502,3/15/13,5,2495,"['Drama', 'Crime']"
It Comes at Night,2017,5000000,13985117,5735086,19720203,14720203,0.7464529143031641,2.9440406,6/9/17,5.8,1141,['Horror']
Before I Fall,2017,5000000,12241072,6704610,18945682,13945682,0.7360876214432397,2.7891364,3/3/17,7,2135,"['Drama', 'Mystery', 'Thriller', 'Fantasy']"
Fifty Shades of Black,2016,5000000,11686940,10426135,22113075,17113075,0.77388943,3.422615,1/29/16,4.4,677,"['Romance', 'Comedy']"
The Perfect Match,2016,5000000,9669521,512529,10182050,5182050,0.5089397518181505,1.03641,3/11/16,5.5,78,"['Comedy', 'Romance']"
Fahrenheit 11/9,2018,5000000,6352306,301409,6653715,1653715,0.24854010128176515,0.330743,9/10/18,7.1,142,['Documentary']
Sea Rex 3D: Journey to a Prehistoric World,2010,5000000,6096582,10418621,16515203,11515203,0.6972486502285198,2.3030406,5/14/10,7.4,12,['Documentary']
90 Minutes in Heaven,2015,5000000,4816142,0,4816142,-183858,-0.038175369,-0.0367716,9/11/15,5.3,63,['Drama']
Incarnate,2016,5000000,4799774,4571262,9371036,4371036,0.46644106372016925,0.8742072,12/2/16,5.2,314,"['Horror', 'Thriller']"
Table 19,2017,5000000,3614896,1005503,4620399,-379601,-0.082157623,-0.0759202,3/3/17,6,604,"['Comedy', 'Drama']"
Green Room,2016,5000000,3220371,587132,3807503,-1192497,-0.313196602,-0.2384994,4/15/16,6.8,1314,"['Horror', 'Crime', 'Thriller']"
Green Room,2016,5000000,3220371,587132,3807503,-1192497,-0.313196602,-0.2384994,4/15/16,6.8,1314,"['Horror', 'Crime', 'Thriller']"
Thoroughbreds,2018,5000000,3072605,114697,3187302,-1812698,-0.568724896,-0.3625396,3/9/18,6.3,398,"['Drama', 'Thriller']"
Thoroughbreds,2018,5000000,3072605,114697,3187302,-1812698,-0.568724896,-0.3625396,3/9/18,6.3,398,"['Drama', 'Thriller']"
The Other Side of the Door,2016,5000000,3000342,9904765,12905107,7905107,0.6125564863584626,1.5810214,3/11/16,5.3,470,"['Thriller', 'Horror']"
Everything Must Go,2011,5000000,2712131,108879,2821010,-2178990,-0.772414844,-0.435798,5/13/11,6,301,"['Comedy', 'Drama', 'Romance']"
Kill the Messenger,2014,5000000,2450846,4205859,6656705,1656705,0.24887763540670646,0.331341,10/10/14,6.6,507,"['Thriller', 'Crime', 'Drama', 'Mystery']"
Rabbit Hole,2010,5000000,2229058,3975976,6205034,1205034,0.19420264256408587,0.2410068,12/16/10,6.8,292,['Drama']
Jem and the Holograms,2015,5000000,2184640,184297,2368937,-2631063,-1.110651317,-0.5262126,10/23/15,5.4,241,"['Drama', 'Fantasy', 'Music']"
Jem and the Holograms,2015,5000000,2184640,184297,2368937,-2631063,-1.110651317,-0.5262126,10/23/15,5.4,241,"['Drama', 'Fantasy', 'Music']"
Paterson,2016,5000000,2141423,8586113,10727536,5727536,0.5339097440456038,1.1455072,12/28/16,7.1,736,"['Comedy', 'Drama', 'Romance']"
Paterson,2016,5000000,2141423,8586113,10727536,5727536,0.5339097440456038,1.1455072,12/28/16,7.1,736,"['Comedy', 'Drama', 'Romance']"
Ain't Them Bodies Saints,2013,5000000,391611,683398,1075009,-3924991,-3.651123851,-0.7849982,8/16/13,6.2,217,"['Crime', 'Drama', 'Romance', 'Western']"
Cop Car,2015,5000000,134552,9106,143658,-4856342,-33.80488382,-0.9712684,8/7/15,5.8,452,['Thriller']
Rudderless,2014,5000000,56001,511218,567219,-4432781,-7.81493744,-0.8865562,10/17/14,7.4,149,"['Music', 'Drama', 'Comedy']"
Area 51,2015,5000000,7556,0,7556,-4992444,-660.7257808,-0.9984888,5/15/15,4.4,248,"['Horror', 'Thriller', 'Science Fiction']"
Dying of the Light,2014,5000000,0,74639,74639,-4925361,-65.98910757,-0.9850722,12/4/14,4.6,174,"['Thriller', 'Drama']"
Yoga Hosers,2016,5000000,0,22958,22958,-4977042,-216.789006,-0.9954084,9/2/16,4.5,221,"['Comedy', 'Fantasy', 'Horror']"
Reach Me,2014,5000000,0,0,0,-5000000,#NAME?,-1,3/14/14,5.2,48,['Drama']
Henry & Me,2014,5000000,0,0,0,-5000000,#NAME?,-1,8/18/14,4.7,3,"['Family', 'Animation']"
We Have Your Husband,2011,5000000,0,0,0,-5000000,#NAME?,-1,11/12/11,5,3,"['TV Movie', 'Crime', 'Drama', 'Thriller']"
Only God Forgives,2013,4800000,775849,3718711,4494560,-305440,-0.067957709,-0.063633333,7/19/13,5.8,1396,"['Drama', 'Thriller', 'Crime']"
Take Shelter,2011,4750000,1728953,3243063,4972016,222016,0.044653115,0.046740211,9/30/11,7.2,787,"['Thriller', 'Drama']"
Without Men,2011,4700000,0,0,0,-4700000,#NAME?,-1,6/29/11,4.5,13,"['Comedy', 'Romance']"
Treading Water,2015,4700000,0,0,0,-4700000,#NAME?,-1,3/13/15,6.2,7,"['Drama', 'Comedy']"
Fast Times at Ridgemont High,1982,4500000,27092880,0,27092880,22592880,0.8339047011613383,5.02064,8/13/82,6.9,563,"['Comedy', 'Drama']"
The Lobster,2016,4500000,9196278,8823556,18019834,13519834,0.7502751690165403,3.0044075555555554,5/13/16,6.9,2895,"['Thriller', 'Comedy', 'Drama', 'Romance', 'Science Fiction']"
The Lobster,2016,4500000,9196278,8823556,18019834,13519834,0.7502751690165403,3.0044075555555554,5/13/16,6.9,2895,"['Thriller', 'Comedy', 'Drama', 'Romance', 'Science Fiction']"
Blackthorn,2011,4500000,200558,1016749,1217307,-3282693,-2.696684567,-0.729487333,10/7/11,6.7,111,"['Adventure', 'Action', 'Western']"
Maggie,2015,4500000,187112,840648,1027760,-3472240,-3.378454114,-0.771608889,5/8/15,5.3,958,"['Horror', 'Drama', 'Mystery']"
The Sweeney,2013,4500000,26345,7974021,8000366,3500366,0.4375257331977062,0.7778591111111111,3/1/13,5.9,142,"['Action', 'Crime']"
Falcon Rising,2014,4500000,11774,0,11774,-4488226,-381.1980635,-0.997383556,9/5/14,5.8,126,"['Adventure', 'Action']"
Zipper,2015,4500000,0,0,0,-4500000,#NAME?,-1,8/28/15,5.7,85,"['Thriller', 'Drama']"
The Final Girls,2015,4500000,0,0,0,-4500000,#NAME?,-1,10/9/15,6.5,619,"['Comedy', 'Horror']"
R.L. Stine's Monsterville: The Cabinet of Souls,2015,4400000,0,0,0,-4400000,#NAME?,-1,9/29/15,6.7,72,"['Comedy', 'Horror']"
Snabba Cash,2012,4300000,188870,10023533,10212403,5912403,0.5789433691561134,1.3749774418604652,7/11/12,6.6,99,"['Drama', 'Thriller', 'Crime']"
Animal Kingdom,2010,4200000,1044039,7034644,8078683,3878683,0.48011328084045385,0.9234959523809524,8/13/10,6.8,399,"['Drama', 'Thriller', 'Crime', 'Mystery']"
Cargo,2011,4200000,0,313230,313230,-3886770,-12.40867733,-0.925421429,10/21/11,4.4,7,"['Drama', 'Thriller']"
The Boy Next Door,2015,4000000,36006065,17395873,53401938,49401938,0.9250963513721169,12.3504845,1/23/15,4.4,1382,['Thriller']
Boyhood,2014,4000000,25379975,31893074,57273049,53273049,0.9301591224870881,13.31826225,7/11/14,7.5,3097,['Drama']
The Kids Are All Right,2010,4000000,20811365,15464104,36275469,32275469,0.8897326454966027,8.06886725,7/9/10,6.6,854,"['Comedy', 'Drama']"
A Haunted House 2,2014,4000000,17329487,3877374,21206861,17206861,0.811381798,4.30171525,4/18/14,5.5,597,"['Comedy', 'Horror']"
The Last Exorcism Part II,2013,4000000,15179303,10269404,25448707,21448707,0.8428210910676129,5.36217675,3/1/13,4.5,297,"['Horror', 'Thriller', 'Drama']"
The Darkness,2016,4000000,10753574,144719,10898293,6898293,0.6329700440243257,1.72457325,5/13/16,4.8,347,"['Horror', 'Thriller']"
Samsara,2012,4000000,2672413,3294258,5966671,1966671,0.32960942542332233,0.49166775,8/22/12,8.2,276,"['Drama', 'Documentary']"
The Art of Getting By,2011,4000000,1430241,558794,1989035,-2010965,-1.011025447,-0.50274125,6/17/11,6.5,752,"['Drama', 'Romance']"
Red State,2011,4000000,1065429,918167,1983596,-2016404,-1.016539658,-0.504101,9/23/11,6.1,472,"['Horror', 'Action', 'Thriller']"
Holy Motors,2012,4000000,641054,3589372,4230426,230426,0.054468746173553205,0.0576065,10/17/12,7,431,"['Drama', 'Fantasy']"
The Signal,2014,4000000,600896,2064426,2665322,-1334678,-0.500756757,-0.3336695,6/13/14,5.9,901,"['Thriller', 'Science Fiction']"
The Face of Love,2014,4000000,385069,773808,1158877,-2841123,-2.451617385,-0.71028075,3/7/14,6.1,68,"['Drama', 'Romance']"
Joe,2014,4000000,373375,0,373375,-3626625,-9.713090057,-0.90665625,4/11/14,6.6,514,['Drama']
Desert Dancer,2015,4000000,155271,441064,596335,-3403665,-5.707639163,-0.85091625,3/20/15,6.9,33,['Drama']
Manglehorn,2015,4000000,132270,665169,797439,-3202561,-4.016057655,-0.80064025,6/19/15,5.4,94,['Drama']
Trust,2011,4000000,120016,0,120016,-3879984,-32.32888948,-0.969996,4/1/11,6.6,556,"['Crime', 'Drama', 'Thriller']"
Praia do Futuro,2015,4000000,20620,740058,760678,-3239322,-4.258466789,-0.8098305,2/27/15,6.4,43,['Drama']
13 Sins,2014,4000000,9134,38418,47552,-3952448,-83.11843876,-0.988112,4/18/14,6.3,576,"['Horror', 'Thriller']"
Another Happy Day,2011,4000000,9120,969407,978527,-3021473,-3.087776832,-0.75536825,11/18/11,6.1,60,"['Comedy', 'Drama']"
Inescapable,2013,4000000,4327,0,4327,-3995673,-923.4280102,-0.99891825,2/22/13,5.2,27,"['Thriller', 'Romance']"
How to Fall in Love,2012,4000000,0,0,0,-4000000,#NAME?,-1,7/21/12,5.9,35,"['Comedy', 'Romance', 'TV Movie']"
Chain of Command,2015,4000000,0,0,0,-4000000,#NAME?,-1,9/8/15,5,20,"['Thriller', 'Adventure', 'Action']"
The Good Heart,2010,3800000,20930,320000,340930,-3459070,-10.14598305,-0.910281579,4/30/10,6.4,30,"['Drama', 'Comedy', 'Romance']"
Hevi reissu,2018,3800000,10153,0,10153,-3789847,-373.2736137,-0.997328158,10/5/18,7,43,"['Comedy', 'Music']"
Four Lions,2010,3750000,310007,2126104,2436111,-1313889,-0.539338725,-0.3503704,11/5/10,7,621,"['Comedy', 'Crime', 'Drama']"
Defendor,2010,3750000,44462,0,44462,-3705538,-83.34168503,-0.988143467,2/26/10,6.4,295,"['Drama', 'Action', 'Comedy', 'Crime']"
Truth or Dare,2018,3500000,41411015,53716329,95127344,91627344,0.9632072141108029,26.179241142857144,4/13/18,6,2005,"['Thriller', 'Horror']"
The Witch,2016,3500000,25138705,15315815,40454520,36954520,0.9134830916298105,10.558434285714286,2/19/16,6.6,2931,"['Mystery', 'Horror']"
The Witch,2016,3500000,25138705,15315815,40454520,36954520,0.9134830916298105,10.558434285714286,2/19/16,6.6,2931,"['Mystery', 'Horror']"
Winchester,2018,3500000,25091816,19286224,44378040,40878040,0.9211321635655834,11.67944,2/2/18,5.7,884,"['Fantasy', 'Mystery', 'Thriller', 'Horror']"
Dark Skies,2013,3500000,17418667,10285444,27704111,24204111,0.8736649589658373,6.9154602857142855,2/22/13,6.1,1004,"['Science Fiction', 'Thriller', 'Horror']"
Forever My Girl,2018,3500000,16376066,0,16376066,12876066,0.786273455,3.678876,1/26/18,7.4,406,"['Romance', 'Drama', 'Music']"
El secreto de sus ojos,2010,3500000,6391436,34136283,40527719,37027719,0.9136393538456976,10.579348285714286,4/16/10,7.9,1141,"['Crime', 'Drama', 'Mystery', 'Romance']"
First Reformed,2018,3500000,3448256,426516,3874772,374772,0.096721046,0.10707771428571429,5/18/18,6.9,446,['Drama']
Believe,2016,3500000,890303,0,890303,-2609697,-2.931245879,-0.745627714,12/2/16,6.5,11,['Drama']
American Honey,2016,3500000,663247,1948503,2611750,-888250,-0.340097636,-0.253785714,9/30/16,6.7,417,['Drama']
The Bronze,2016,3500000,615816,0,615816,-2884184,-4.683515855,-0.824052571,3/18/16,5.8,186,"['Drama', 'Comedy']"
The Bronze,2016,3500000,615816,0,615816,-2884184,-4.683515855,-0.824052571,3/18/16,5.8,186,"['Drama', 'Comedy']"
Trolljegeren,2011,3500000,253444,5453194,5706638,2206638,0.38667916205653835,0.630468,6/10/11,6.7,806,"['Fantasy', 'Horror']"
The Masked Saint,2016,3500000,182695,0,182695,-3317305,-18.15761241,-0.947801429,1/8/16,3.5,16,"['Crime', 'Action']"
"Batman: The Dark Knight Returns, Part 2",2013,3500000,0,0,0,-3500000,#NAME?,-1,1/29/13,7.9,689,"['Action', 'Animation', 'Mystery']"
In the Name of the King III,2014,3500000,0,0,0,-3500000,#NAME?,-1,3/11/14,3.5,31,"['Action', 'Adventure', 'Drama', 'Fantasy']"
Wicked Blood,2014,3500000,0,0,0,-3500000,#NAME?,-1,3/4/14,5.5,52,"['Action', 'Drama', 'Thriller']"
Dawn Patrol,2015,3500000,0,0,0,-3500000,#NAME?,-1,6/5/15,5.1,15,['Drama']
Jagten,2013,3450000,687185,17622608,18309793,14859793,0.8115762422873923,4.307186376811594,7/12/13,8,1634,['Drama']
Margin Call,2011,3400000,5353586,15079641,20433227,17033227,0.833604354,5.009772647058823,10/21/11,6.8,856,"['Thriller', 'Drama']"
Whiplash,2014,3300000,13092006,25877031,38969037,35669037,0.9153173839014805,10.80879909090909,10/10/14,8.4,7908,"['Drama', 'Music']"
Sorry to Bother You,2018,3200000,17493096,792464,18285560,15085560,0.8249985234250414,4.7142375,7/6/18,6.9,481,"['Fantasy', 'Science Fiction', 'Comedy']"
Beginners,2011,3200000,5790894,8523513,14314407,11114407,0.7764489999480942,3.473252188,6/17/11,6.9,532,"['Drama', 'Romance', 'Comedy']"
The Meddler,2016,3200000,4267219,1259723,5526942,2326942,0.42101798788552514,0.727169375,4/22/16,5.8,186,"['Comedy', 'Drama']"
Antiviral,2013,3100000,0,123407,123407,-2976593,-24.12013095,-0.96019129,4/12/13,5.8,152,"['Science Fiction', 'Horror']"
Paranormal Activity 2,2010,3000000,84752907,92759125,177512032,174512032,0.9830997371490852,58.17067733333333,10/21/10,5.7,1342,"['Horror', 'Thriller']"
War Room,2015,3000000,67790117,6185122,73975239,70975239,0.9594458897253445,23.658413,8/28/15,7.5,171,"['Drama', 'Romance']"
The Purge,2013,3000000,64473115,26793466,91266581,88266581,0.9671292605997808,29.422193666666665,6/6/13,6.2,4797,"['Science Fiction', 'Horror', 'Thriller']"
Sinister,2012,3000000,48086903,39640904,87727807,84727807,0.9658033170714048,28.242602333333334,10/12/12,6.8,2935,"['Horror', 'Thriller', 'Mystery']"
Upgrade,2018,3000000,11977130,4576155,16553285,13553285,0.8187670906409211,4.517761666666667,6/1/18,7.4,1326,"['Action', 'Thriller', 'Science Fiction']"
Before Midnight,2013,3000000,8110621,15141309,23251930,20251930,0.8709784521112871,6.7506433333333336,6/14/13,7.4,1039,"['Romance', 'Drama']"
Let There Be Light,2017,3000000,7233471,7838,7241309,4241309,0.5857102631582218,1.4137696666666666,10/27/17,6.2,23,['Drama']
Let There Be Light,2017,3000000,7233471,7838,7241309,4241309,0.5857102631582218,1.4137696666666666,3/10/17,7.3,3,['Documentary']
Swiss Army Man,2016,3000000,4210454,1626657,5837111,2837111,0.4860471215983386,0.9457036666666667,6/24/16,6.9,1789,"['Comedy', 'Drama', 'Romance', 'Fantasy', 'Adventure']"
Frances Ha,2013,3000000,4067398,7195371,11262769,8262769,0.7336356627752909,2.754256333333333,5/17/13,7.4,624,"['Comedy', 'Drama']"
Frances Ha,2013,3000000,4067398,7195371,11262769,8262769,0.7336356627752909,2.754256333333333,5/17/13,7.4,624,"['Comedy', 'Drama']"
Please Give,2010,3000000,4033574,536604,4570178,1570178,0.3435704254845216,0.5233926666666666,1/22/10,6.3,81,"['Comedy', 'Drama']"
Compadres,2016,3000000,3127773,4317271,7445044,4445044,0.5970473780947433,1.4816813333333334,4/22/16,5.1,21,"['Action', 'Comedy']"
Letters to God,2010,3000000,2848587,388865,3237452,237452,0.073345335,0.079150667,4/9/10,6.9,71,"['Drama', 'Family']"
Tusk,2014,3000000,1821983,65571,1887554,-1112446,-0.589358503,-0.370815333,9/19/14,5.3,601,"['Comedy', 'Horror', 'Drama', 'Thriller']"
The Wall,2017,3000000,1803064,2692198,4495262,1495262,0.33263066757844145,0.4984206666666667,5/12/17,6.1,407,"['Thriller', 'War', 'Drama']"
Damsels in Distress,2012,3000000,1007535,316764,1324299,-1675701,-1.265349441,-0.558567,4/6/12,5.5,103,"['Comedy', 'Romance']"
Hobo with a Shotgun,2011,3000000,703372,131581,834953,-2165047,-2.593016613,-0.721682333,5/6/11,5.9,300,"['Crime', 'Action', 'Thriller']"
The D Train,2015,3000000,669688,102678,772366,-2227634,-2.884168904,-0.742544667,5/8/15,4.6,125,"['Drama', 'Comedy']"
Bachelorette,2012,3000000,446770,12130631,12577401,9577401,0.761476954,3.192467,9/6/12,5.4,755,"['Comedy', 'Romance']"
Creature,2011,3000000,331000,0,331000,-2669000,-8.063444109,-0.889666667,9/9/11,4.1,23,['Horror']
The Bounce Back,2016,3000000,321910,99494,421404,-2578596,-6.119059145,-0.859532,2/26/16,6.1,31,['Romance']
Chain Letter,2010,3000000,205842,816611,1022453,-1977547,-1.934120199,-0.659182333,10/1/10,4.1,63,"['Horror', 'Thriller']"
Tim and Eric's Billion Dollar Movie,2012,3000000,201436,22216,223652,-2776348,-12.41369628,-0.925449333,3/2/12,5.7,61,['Comedy']
Fort McCoy,2014,3000000,78948,0,78948,-2921052,-36.999696,-0.973684,1/1/14,6.3,2,"['War', 'Drama', 'History']"
Before We Go,2015,3000000,37151,446787,483938,-2516062,-5.199141212,-0.838687333,5/21/15,6.5,985,"['Drama', 'Romance', 'Comedy']"
Tanner Hall,2011,3000000,5073,0,5073,-2994927,-590.3660556,-0.998309,9/9/11,5.9,66,['Drama']
They Came Together,2014,3000000,0,82780,82780,-2917220,-35.24063784,-0.972406667,6/27/14,5.5,226,['Comedy']
Open Road,2013,3000000,0,47469,47469,-2952531,-62.19914049,-0.984177,5/21/13,5.1,20,"['Action', 'Drama', 'Thriller']"
Barry Munday,2010,3000000,0,0,0,-3000000,#NAME?,-1,3/13/10,6,37,"['Comedy', 'Drama', 'Romance']"
Never Back Down 2: The Beatdown,2011,3000000,0,0,0,-3000000,#NAME?,-1,9/13/11,6,257,"['Drama', 'Action']"
AWOL-72,2015,3000000,0,0,0,-3000000,#NAME?,-1,8/7/15,3.8,22,['Thriller']
Amnesiac,2015,3000000,0,0,0,-3000000,#NAME?,-1,8/14/15,4.5,95,"['Thriller', 'Mystery', 'Drama', 'Horror']"
Unnatural,2015,3000000,0,0,0,-3000000,#NAME?,-1,10/16/15,4.3,22,"['Action', 'Horror', 'Thriller']"
Close Range,2015,3000000,0,0,0,-3000000,#NAME?,-1,12/11/15,5.2,87,"['Action', 'Crime']"
Freakonomics,2010,2900000,101270,71597,172867,-2727133,-15.77590286,-0.94039069,10/1/10,6.6,57,['Documentary']
Griff the Invisible,2011,2900000,20778,5157,25935,-2874065,-110.8180066,-0.991056897,8/19/11,6,44,"['Romance', 'Comedy', 'Drama']"
Indivisible,2018,2700000,3511417,76888,3588305,888305,0.2475556007641491,0.3290018518518519,10/26/18,5.4,13,"['Drama', 'War']"
Ida,2014,2600000,3827060,11471295,15298355,12698355,0.8300470867619427,4.8839826923076926,5/2/14,7.3,455,['Drama']
A Haunted House,2013,2500000,40041683,19880875,59922558,57422558,0.9582794846641894,22.9690232,1/11/13,5.5,871,"['Comedy', 'Horror']"
Kevin Hart: Let Me Explain,2013,2500000,32244051,83204,32327255,29827255,0.9226658743527714,11.930902,7/3/13,6.9,142,"['Comedy', 'Documentary']"
The Spectacular Now,2013,2500000,6852971,63980,6916951,4416951,0.6385690747267112,1.7667804,9/13/13,6.6,1801,"['Comedy', 'Drama', 'Romance']"
Hunt for the Wilderpeople,2016,2500000,5205471,18640062,23845533,21345533,0.8951585607249793,8.5382132,6/24/16,7.8,915,"['Adventure', 'Comedy', 'Drama']"
Robot & Frank,2012,2500000,3317468,1616888,4934356,2434356,0.4933482707773821,0.9737424,8/16/12,6.9,620,"['Science Fiction', 'Comedy', 'Drama', 'Crime']"
The Lost Medallion: The Adventures of Billy Stone,2013,2500000,549632,0,549632,-1950368,-3.548497904,-0.7801472,3/1/13,5.5,21,"['Adventure', 'Family']"
Super,2011,2500000,327716,266217,593933,-1906067,-3.209228987,-0.7624268,3/31/11,6.6,726,"['Comedy', 'Action', 'Drama']"
8: The Mormon Proposition,2010,2500000,100280,0,100280,-2399720,-23.93019545,-0.959888,1/1/10,6.2,11,['Documentary']
Underdogs,2013,2500000,35017,1357632,1392649,-1107351,-0.795140053,-0.4429404,4/6/13,5.5,16,"['Drama', 'Family']"
Christmas Mail,2010,2500000,0,0,0,-2500000,#NAME?,-1,12/1/10,5.4,29,"['Comedy', 'Family']"
Stung,2015,2500000,0,0,0,-2500000,#NAME?,-1,7/3/15,5.1,91,"['Comedy', 'Horror']"
Antibirth,2016,2500000,0,0,0,-2500000,#NAME?,-1,9/2/16,4.8,66,['Horror']
Do You Believe?,2015,2300000,12985600,1319331,14304931,12004931,0.8392162814347025,5.2195352173913045,3/20/15,7,72,"['Fantasy', 'Drama']"
Frontera,2014,2300000,59696,0,59696,-2240304,-37.52854463,-0.974045217,9/5/14,6.3,80,"['Western', 'Drama']"
Redemption Road,2011,2300000,29384,0,29384,-2270616,-77.27389055,-0.987224348,8/26/11,4.7,6,['Drama']
The Best Years of Our Lives,1946,2100000,23600000,0,23600000,21500000,0.9110169491525424,10.238095238095237,12/25/46,7.8,243,"['Drama', 'History', 'Romance']"
Infected,2012,2100000,0,0,0,-2100000,#NAME?,-1,10/31/12,2.4,8,['Horror']
Lies in Plain Sight,2010,2100000,0,0,0,-2100000,#NAME?,-1,10/3/10,6,4,"['Drama', 'Mystery', 'Thriller']"
Courageous,2011,2000000,34522221,663663,35185884,33185884,0.9431590236584648,16.592942,9/30/11,7,128,['Drama']
It Follows,2015,2000000,14674077,8576678,23250755,21250755,0.9139812879194675,10.6253775,3/27/15,6.5,3485,"['Horror', 'Thriller']"
It Follows,2015,2000000,14674077,8576678,23250755,21250755,0.9139812879194675,10.6253775,3/27/15,6.5,3485,"['Horror', 'Thriller']"
Eighth Grade,2018,2000000,13539710,801306,14341016,12341016,0.8605398669104057,6.170508,7/13/18,7.4,519,"['Comedy', 'Drama']"
Hardcore Henry,2016,2000000,9252038,7935396,17187434,15187434,0.8836359167982841,7.593717,4/6/16,6.2,1294,"['Action', 'Adventure', 'Science Fiction']"
Winter's Bone,2010,2000000,6531503,9600048,16131551,14131551,0.8760193610645375,7.0657755,6/11/10,6.9,931,['Drama']
The Florida Project,2017,2000000,5904366,5390958,11295324,9295324,0.8229355793600963,4.647662,10/6/17,7.4,1125,['Drama']
All Saints,2017,2000000,5802208,139786,5941994,3941994,0.6634126523857143,1.970997,8/25/17,6.1,25,"['Drama', 'Comedy']"
Inside Job,2010,2000000,4311834,3487423,7799257,5799257,0.7435653165423322,2.8996285,10/8/10,7.8,466,['Documentary']
We Are Your Friends,2015,2000000,3591417,6561998,10153415,8153415,0.8030219389239975,4.0767075,8/28/15,6.3,1241,"['Drama', 'Music', 'Romance', 'Comedy']"
Captive,2015,2000000,2583301,208672,2791973,791973,0.2836606944264862,0.3959865,9/18/15,5.6,127,"['Crime', 'Drama', 'Thriller']"
Hearts Beat Loud,2018,2000000,2386254,34708,2420962,420962,0.1738821179349366,0.210481,6/8/18,7.4,87,"['Drama', 'Music', 'Comedy']"
The Resurrection of Gavin Stone,2017,2000000,2303792,0,2303792,303792,0.13186607124254274,0.151896,1/20/17,6.7,10,"['Comedy', 'Drama']"
The Diary of a Teenage Girl,2015,2000000,1477002,802957,2279959,279959,0.12279124317586412,0.1399795,8/28/15,6.7,460,"['Drama', 'Romance']"
Locke,2014,2000000,1370646,717744,2088390,88390,0.04232447,0.044195,4/25/14,6.9,1370,"['Drama', 'Thriller']"
The Babadook,2014,2000000,950792,6531595,7482387,5482387,0.7327056192094848,2.7411935,11/28/14,6.4,3528,"['Drama', 'Horror']"
The Virginity Hit,2010,2000000,636706,0,636706,-1363294,-2.141167195,-0.681647,9/10/10,4.6,35,['Comedy']
The Last Five Years,2015,2000000,147299,57999,205298,-1794702,-8.741936112,-0.897351,2/13/15,5.9,230,"['Comedy', 'Drama', 'Music', 'Romance']"
Lost River,2015,2000000,45431,1964213,2009644,9644,0.00479886,0.004822,4/10/15,5.8,352,"['Fantasy', 'Thriller', 'Drama']"
Knock Knock,2015,2000000,36336,6292180,6328516,4328516,0.6839701440274466,2.164258,10/9/15,5,1490,"['Drama', 'Thriller']"
The First Time,2012,2000000,17061,0,17061,-1982939,-116.2264228,-0.9914695,10/19/12,7,1426,"['Drama', 'Comedy', 'Romance']"
Circle,2010,2000000,10024,0,10024,-1989976,-198.5211492,-0.994988,9/11/10,3.8,6,"['Horror', 'Thriller']"
Plush,2013,2000000,3080,25784,28864,-1971136,-68.29046563,-0.985568,9/13/13,5.7,64,['Thriller']
Grave Encounters,2011,2000000,0,2151887,2151887,151887,0.070583167,0.0759435,9/9/11,6.2,700,"['Thriller', 'Horror']"
Bone Tomahawk,2015,2000000,0,475846,475846,-1524154,-3.203040479,-0.762077,10/23/15,6.8,905,"['Horror', 'Western']"
Straight A's,2013,2000000,0,0,0,-2000000,#NAME?,-1,3/19/13,5.3,71,"['Comedy', 'Drama']"
Highway,2012,2000000,0,0,0,-2000000,#NAME?,-1,9/9/12,2.7,3,[None]
Coffee Town,2013,2000000,0,0,0,-2000000,#NAME?,-1,7/9/13,6.7,56,['Comedy']
Lucky Dog,2014,2000000,0,0,0,-2000000,#NAME?,-1,1/1/14,4,1,[None]
The Curse of Downers Grove,2015,2000000,0,0,0,-2000000,#NAME?,-1,8/21/15,4.7,42,"['Thriller', 'Mystery', 'Horror', 'Drama']"
Wind Walkers,2015,2000000,0,0,0,-2000000,#NAME?,-1,10/16/15,6,8,"['Action', 'Horror', 'Thriller']"
The Dog Lover,2016,2000000,0,0,0,-2000000,#NAME?,-1,7/8/16,5.9,11,['Drama']
Shark Lake,2015,2000000,0,0,0,-2000000,#NAME?,-1,10/2/15,3.9,31,['Thriller']
Buried,2010,1987650,1044143,20226147,21270290,19282640,0.9065527550400112,9.701225064774986,9/24/10,6.6,1487,"['Drama', 'Thriller', 'Mystery']"
Nowhere Boy,2010,1900000,1445366,6339863,7785229,5885229,0.755948091,3.097488947368421,1/27/10,7.3,469,['Drama']
Brotherly Love,2015,1900000,478595,0,478595,-1421405,-2.969953719,-0.748107895,4/24/15,6.8,53,['Drama']
Submarine,2011,1900000,467602,4114335,4581937,2681937,0.5853282138100109,1.4115457894736843,6/3/11,7.4,770,"['Drama', 'Comedy', 'Romance']"
Stranded,2013,1900000,0,285593,285593,-1614407,-5.652824124,-0.849687895,7/26/13,3.6,73,"['Horror', 'Science Fiction']"
The Last Exorcism,2010,1800000,41034350,29131550,70165900,68365900,0.9743465130497863,37.98105555555556,8/27/10,5.6,519,"['Horror', 'Drama', 'Thriller']"
Carrie,1976,1800000,25878153,0,25878153,24078153,0.9304432584504775,13.376751666666667,11/3/76,7.1,1766,"['Horror', 'Thriller']"
Beasts of the Southern Wild,2012,1800000,12795746,10469386,23265132,21465132,0.9226309999014835,11.925073333333334,6/29/12,6.9,605,"['Drama', 'Fantasy', 'Adventure']"
Higher Ground,2011,1800000,841056,1637,842693,-957307,-1.136009199,-0.531837222,8/26/11,5.9,21,"['Drama', 'Thriller']"
Dysfunctional Friends,2012,1800000,0,0,0,-1800000,#NAME?,-1,2/3/12,5.3,6,"['Comedy', 'Romance']"
Independence Daysaster,2013,1800000,0,0,0,-1800000,#NAME?,-1,6/27/13,4.2,35,"['Action', 'Science Fiction']"
Against the Wild,2014,1800000,0,0,0,-1800000,#NAME?,-1,3/11/14,5.2,27,"['Adventure', 'Family']"
I Spit on Your Grave,2010,1750000,93051,1185420,1278471,-471529,-0.368822601,-0.269445143,10/8/10,6.3,977,"['Thriller', 'Crime', 'Horror']"
The Lunchbox,2014,1700000,4231500,8000000,12231500,10531500,0.8610145934676859,6.195,2/28/14,7.3,350,"['Drama', 'Romance']"
Grace Unplugged,2013,1700000,2507159,0,2507159,807159,0.32194168778286497,0.47479941176470586,10/4/13,6.3,38,"['Drama', 'Music']"
Saul fia,2015,1700000,1777043,7919494,9696537,7996537,0.8246796768784567,4.703845294117647,12/18/15,7.2,506,"['War', 'Drama', 'Thriller']"
Braid,2019,1660000,0,80745,80745,-1579255,-19.55854852,-0.951358434,2/1/19,6.4,18,"['Thriller', 'Drama', 'Horror']"
N-Secure,2010,1600000,2595644,0,2595644,995644,0.38358264846797174,0.6222775,10/15/10,4.8,6,"['Drama', 'Crime', 'Thriller']"
Two Night Stand,2014,1600000,15600,852481,868081,-731919,-0.843145974,-0.457449375,9/26/14,6.5,1241,"['Romance', 'Comedy']"
Insidious,2011,1500000,54009150,45861736,99870886,98370886,0.984980608,65.58059066666667,4/1/11,6.9,3582,"['Horror', 'Thriller']"
Moonlight,2016,1500000,27854931,37390581,65245512,63745512,0.9770099129576912,42.497008,10/21/16,7.4,3893,['Drama']
Moonlight,2016,1500000,27854931,37390581,65245512,63745512,0.9770099129576912,42.497008,10/21/16,7.4,3893,['Drama']
Unsane,2018,1500000,7690044,6554887,14244931,12744931,0.894699385,8.496620666666667,3/23/18,6.2,667,"['Horror', 'Thriller']"
The To Do List,2013,1500000,3491669,637159,4128828,2628828,0.6367007780416137,1.752552,7/26/13,5.5,534,"['Comedy', 'Romance']"
The Gatekeepers,2013,1500000,2408553,183755,2592308,1092308,0.42136505384391054,0.7282053333333334,2/1/13,7.2,51,['Documentary']
Blood Simple,1985,1500000,1690913,1039964,2730877,1230877,0.4507259023383331,0.8205846666666666,1/18/85,7.4,554,"['Crime', 'Drama', 'Thriller']"
The Lords of Salem,2013,1500000,1165881,375250,1541131,41131,0.026688840857785612,0.027420666666666666,4/19/13,5.3,445,"['Horror', 'Thriller']"
31,2016,1500000,779820,142907,922727,-577273,-0.625616244,-0.384848667,10/21/16,5.2,370,"['Horror', 'Thriller', 'Mystery']"
Amigo,2011,1500000,184705,0,184705,-1315295,-7.121057903,-0.876863333,8/19/11,4.8,4,"['Drama', 'History', 'War']"
The Disappearance of Alice Creed,2010,1500000,166980,1438159,1605139,105139,0.065501492,0.070092667,4/30/10,6.6,280,"['Crime', 'Drama', 'Thriller']"
The Square,2013,1500000,124244,52018,176262,-1323738,-7.51005889,-0.882492,10/25/13,7.8,84,"['Documentary', 'Drama', 'History']"
Road Hard,2015,1500000,113169,0,113169,-1386831,-12.25451316,-0.924554,3/6/15,6.6,12,['Comedy']
Housebound,2014,1500000,0,236863,236863,-1263137,-5.332774642,-0.842091333,10/17/14,6.6,505,"['Horror', 'Comedy', 'Thriller']"
Teefa in Trouble,2018,1500000,0,98806,98806,-1401194,-14.1812643,-0.934129333,7/20/18,7.6,11,"['Drama', 'Comedy', 'Action', 'Crime']"
The Lion of Judah,2011,1500000,0,0,0,-1500000,#NAME?,-1,6/3/11,4.5,3,"['Adventure', 'Animation', 'Comedy', 'Family']"
#Horror,2015,1500000,0,0,0,-1500000,#NAME?,-1,11/20/15,3.3,102,"['Drama', 'Mystery', 'Horror', 'Thriller']"
Checkmate,2015,1500000,0,0,0,-1500000,#NAME?,-1,7/3/15,4.2,20,"['Thriller', 'Action', 'Crime']"
Mustang,2015,1400000,845464,4707120,5552584,4152584,0.7478651381050696,2.9661314285714284,11/20/15,8,755,['Drama']
La chambre bleue,2014,1400000,260441,1684979,1945420,545420,0.28036105314019594,0.3895857142857143,10/3/14,6.6,52,"['Drama', 'Crime', 'Thriller']"
Eddie: The Sleepwalking Cannibal,2013,1400000,1632,0,1632,-1398368,-856.8431373,-0.998834286,4/5/13,6.2,33,"['Horror', 'Comedy']"
My Girlfriend's Boyfriend,2010,1400000,0,0,0,-1400000,#NAME?,-1,4/22/10,5.9,68,['Comedy']
House at the End of the Drive,2014,1400000,0,0,0,-1400000,#NAME?,-1,1/11/14,8,1,"['Thriller', 'Horror']"
Above and Beyond,2015,1300000,288751,0,288751,-1011249,-3.50214891,-0.777883846,1/30/15,8,5,"['War', 'Documentary', 'Adventure', 'History']"
The Algerian,2015,1300000,0,0,0,-1300000,#NAME?,-1,8/7/15,4.5,2,"['Action', 'Thriller']"
Dear White People,2014,1250000,4404154,999617,5403771,4153771,0.7686800569454183,3.3230168,10/17/14,6.1,296,"['Comedy', 'Drama']"
Filly Brown,2013,1250000,2850357,90054,2940411,1690411,0.5748893607050171,1.3523288,4/19/13,6.5,10,['Drama']
Saw,2004,1200000,55968727,47911300,103880027,102680027,0.9884482124749544,85.56668916666666,10/29/04,7.4,4795,"['Horror', 'Mystery', 'Crime']"
Home Run,2013,1200000,2859955,0,2859955,1659955,0.5804129785258859,1.3832958333333334,4/19/13,6.3,33,['Drama']
Blue Like Jazz,2012,1200000,595018,0,595018,-604982,-1.016745712,-0.504151667,4/13/12,5.9,35,"['Drama', 'Comedy']"
Que Horas Ela Volta?,2015,1200000,376976,2872065,3249041,2049041,0.6306602471313844,1.7075341666666666,8/28/15,8,351,['Drama']
"Pink Ribbons, Inc.",2012,1200000,26608,0,26608,-1173392,-44.09921828,-0.977826667,4/21/12,6.8,6,['Documentary']
Crowsnest,2012,1200000,0,0,0,-1200000,#NAME?,-1,1/1/12,4.9,18,[None]
Serbuan maut,2012,1100000,4105123,5192284,9297407,8197407,0.8816874425310197,7.452188181818181,4/13/12,7.4,1626,"['Action', 'Thriller', 'Crime']"
The Sleepwalker,2014,1100000,2636,0,2636,-1097364,-416.2989378,-0.997603636,1/20/14,4.1,9,['Drama']
The Dead Undead,2010,1100000,0,0,0,-1100000,#NAME?,-1,5/13/10,3.1,9,"['Horror', 'Science Fiction', 'Action']"
The Vatican Exorcisms,2013,1100000,0,0,0,-1100000,#NAME?,-1,5/29/13,4.2,14,"['Horror', 'Documentary', 'Mystery']"
The Devil Inside,2012,1000000,53262945,48496545,101759490,100759490,0.9901729067234909,100.75949,1/6/12,4.7,441,"['Thriller', 'Horror']"
Unfriended,2015,1000000,32789645,31574553,64364198,63364198,0.984463412,63.364198,4/17/15,5.4,2019,"['Horror', 'Thriller']"
You're Next,2013,1000000,18494006,8393171,26887177,25887177,0.9628075494872519,25.887177,8/23/13,6.6,1258,"['Horror', 'Thriller', 'Mystery']"
Chernobyl Diaries,2012,1000000,18119640,24292081,42411721,41411721,0.9764216123179722,41.411721,5/25/12,5,842,"['Horror', 'Thriller']"
Blue Valentine,2010,1000000,9737892,6828348,16566240,15566240,0.9396362723225065,15.56624,12/29/10,6.9,1677,"['Drama', 'Romance']"
Blue Valentine,2010,1000000,9737892,6828348,16566240,15566240,0.9396362723225065,15.56624,12/29/10,6.9,1677,"['Drama', 'Romance']"
Unfriended: Dark Web,2018,1000000,8866745,7567843,16434588,15434588,0.9391527186443616,15.434588,7/20/18,6.1,365,['Horror']
I Am Not Your Negro,2017,1000000,7123919,2493483,9617402,8617402,0.8960218154549431,8.617402,2/3/17,8.1,196,['Documentary']
The Sessions,2012,1000000,6002451,5492753,11495204,10495204,0.9130071984803402,10.495204,10/18/12,6.9,296,"['Drama', 'Romance', 'Comedy']"
The Skeleton Twins,2014,1000000,5284309,512883,5797192,4797192,0.8275026944079134,4.797192,9/12/14,6.7,394,['Drama']
Obvious Child,2014,1000000,3122616,201454,3324070,2324070,0.6991639766912249,2.32407,6/6/14,6.7,256,"['Comedy', 'Romance']"
Martha Marcy May Marlene,2011,1000000,2981038,2457873,5438911,4438911,0.8161396647233242,4.438911,10/21/11,6.7,413,"['Drama', 'Thriller']"
Patti Cake$,2017,1000000,800148,670942,1471090,471090,0.3202319368631423,0.47109,8/18/17,7,122,['Drama']
Palo Alto,2014,1000000,767732,388577,1156309,156309,0.13517926436618585,0.156309,5/9/14,6.4,528,['Drama']
Palo Alto,2014,1000000,767732,388577,1156309,156309,0.13517926436618585,0.156309,5/9/14,6.4,528,['Drama']
The Future,2011,1000000,568662,670512,1239174,239174,0.19301082818070747,0.239174,7/29/11,5.8,38,"['Comedy', 'Drama']"
23 Blast,2014,1000000,549185,0,549185,-450815,-0.820880031,-0.450815,10/24/14,6.5,31,['Drama']
I Origins,2014,1000000,336472,515927,852399,-147601,-0.173159518,-0.147601,7/18/14,7.6,1814,"['Science Fiction', 'Drama']"
Hardflip,2012,1000000,96734,0,96734,-903266,-9.337626894,-0.903266,6/1/12,5,7,"['Drama', 'Action']"
Creative Control,2016,1000000,63014,0,63014,-936986,-14.86948932,-0.936986,3/11/16,5.6,36,"['Drama', 'Science Fiction']"
Creative Control,2016,1000000,63014,0,63014,-936986,-14.86948932,-0.936986,3/11/16,5.6,36,"['Drama', 'Science Fiction']"
Camp X-Ray,2014,1000000,9837,91216,101053,-898947,-8.895797255,-0.898947,10/17/14,6.8,618,['Drama']
The Sisterhood of Night,2015,1000000,6870,0,6870,-993130,-144.5604076,-0.99313,4/10/15,6.4,51,"['Mystery', 'Drama', 'Thriller']"
The Sisterhood of Night,2015,1000000,6870,0,6870,-993130,-144.5604076,-0.99313,4/10/15,6.4,51,"['Mystery', 'Drama', 'Thriller']"
Childless,2015,1000000,1036,0,1036,-998964,-964.2509653,-0.998964,4/3/15,4.5,2,[None]
Heli,2013,1000000,0,552614,552614,-447386,-0.809581371,-0.447386,10/19/13,6.4,46,"['Crime', 'Drama', 'Romance']"
American Hero,2015,1000000,0,26,26,-999974,-38460.53846,-0.999974,12/11/15,5,93,"['Action', 'Comedy', 'Science Fiction']"
Snow White: A Deadly Summer,2012,1000000,0,0,0,-1000000,#NAME?,-1,3/16/12,4.1,14,"['Horror', 'Thriller']"
Doc Holliday's Revenge,2014,1000000,0,0,0,-1000000,#NAME?,-1,6/1/14,3.2,3,['Western']
Hush,2016,1000000,0,0,0,-1000000,#NAME?,-1,3/12/16,6.8,2147,"['Horror', 'Thriller']"
Chemical Cut,2016,1000000,0,0,0,-1000000,#NAME?,-1,1/24/16,10,1,"['Comedy', 'Drama']"
Lowriders,2017,916000,6179955,8466,6188421,5272421,0.8519816282699577,5.755918122270742,5/12/17,6.5,46,['Drama']
Lowriders,2017,916000,6179955,8466,6188421,5272421,0.8519816282699577,5.755918122270742,5/12/17,6.5,46,['Drama']
Fruitvale Station,2013,900000,16098998,1450647,17549645,16649645,0.9487169113677228,18.499605555555554,7/26/13,7.4,645,['Drama']
Meet the Blacks,2016,900000,9097072,0,9097072,8197072,0.901067069,9.107857777777777,4/1/16,4.4,139,"['Comedy', 'Horror']"
Circumstance,2011,900000,454121,504857,958978,58978,0.061500889488601405,0.065531111,8/26/11,6.9,45,['Drama']
The Giant Mechanical Man,2012,900000,7396,0,7396,-892604,-120.6873986,-0.991782222,4/27/12,6.3,70,"['Comedy', 'Drama', 'Romance']"
The Brass Teapot,2013,900000,6997,406736,413733,-486267,-1.175315965,-0.540296667,4/5/13,6,240,"['Comedy', 'Fantasy', 'Thriller']"
Windsor Drive,2015,850000,3256,0,3256,-846744,-260.0565111,-0.996169412,6/26/15,2.5,4,"['Thriller', 'Mystery']"
Not Cool,2014,800000,35688,0,35688,-764312,-21.41649854,-0.95539,9/23/14,4.2,50,['Comedy']
Kill List,2012,800000,29063,433143,462206,-337794,-0.730829976,-0.4222425,1/4/12,6.1,332,"['Horror', 'Thriller', 'Crime']"
Kevin Hart: Laugh at My Pain,2011,750000,7706436,6000,7712436,6962436,0.9027544604584077,9.283248,9/9/11,7.4,76,"['Comedy', 'Documentary']"
Safety Not Guaranteed,2012,750000,4010957,411361,4422318,3672318,0.8304056831733946,4.896424,6/8/12,6.9,792,"['Comedy', 'Romance', 'Science Fiction', 'Drama']"
All the Boys Love Mandy Lane,2013,750000,0,1960521,1960521,1210521,0.6174486271761435,1.614028,10/11/13,5.5,326,"['Horror', 'Mystery', 'Thriller']"
Adulterers,2016,750000,0,0,0,-750000,#NAME?,-1,1/5/16,5.2,29,"['Thriller', 'Crime', 'Drama']"
Columbus,2017,700000,1017107,93404,1110511,410511,0.3696595531246426,0.5864442857142858,8/4/17,7.3,130,['Drama']
Walter,2015,700000,0,0,0,-700000,#NAME?,-1,3/13/15,5.5,31,"['Drama', 'Comedy']"
Escape from Tomorrow,2013,650000,171962,0,171962,-478038,-2.779904863,-0.735443077,10/11/13,4.8,117,"['Horror', 'Fantasy']"
After,2012,650000,0,0,0,-650000,#NAME?,-1,9/14/12,5.7,86,"['Mystery', 'Thriller']"
Treachery,2013,625000,0,0,0,-625000,#NAME?,-1,12/4/13,4.8,5,['Drama']
Water & Power,2014,600000,42557,0,42557,-557443,-13.09873816,-0.929071667,5/2/14,3,1,"['Crime', 'Drama']"
Drunk Wedding,2015,600000,3301,0,3301,-596699,-180.7631021,-0.994498333,5/22/15,3.9,15,['Comedy']
The Maid's Room,2014,600000,0,0,0,-600000,#NAME?,-1,8/8/14,4.8,6,['Thriller']
The Maid's Room,2014,600000,0,0,0,-600000,#NAME?,-1,8/8/14,4.8,6,['Thriller']
High Road,2012,546173,0,0,0,-546173,#NAME?,-1,3/6/12,5.6,38,['Comedy']
Drinking Buddies,2013,500000,343706,63394,407100,-92900,-0.22819946,-0.1858,8/23/13,6,528,"['Romance', 'Drama']"
Monsters,2010,500000,237301,5402429,5639730,5139730,0.9113432735255057,10.27946,10/29/10,6.2,848,"['Drama', 'Thriller', 'Science Fiction']"
O Menino e o Mundo,2015,500000,129479,151488,280967,-219033,-0.779568419,-0.438066,12/11/15,7.3,114,"['Animation', 'Adventure', 'Family', 'Science Fiction']"
Born to Fly: Elizabeth Streb vs. Gravity,2014,500000,1822,0,1822,-498178,-273.4237102,-0.996356,3/8/14,5.5,2,['Documentary']
Higher Power,2018,500000,528,0,528,-499472,-945.969697,-0.998944,5/11/18,4.9,43,"['Action', 'Science Fiction', 'Thriller']"
Drones,2010,500000,0,0,0,-500000,#NAME?,-1,1/23/10,5.2,5,"['Comedy', 'Science Fiction']"
Girls Gone Dead,2012,500000,0,0,0,-500000,#NAME?,-1,3/28/12,3.5,20,"['Horror', 'Comedy']"
Subconscious,2015,500000,0,0,0,-500000,#NAME?,-1,3/10/15,3.1,7,"['Action', 'Thriller', 'Mystery']"
As It Is in Heaven,2014,450000,13486,0,13486,-436514,-32.36793712,-0.970031111,8/15/14,8,1,['Drama']
Blue Ruin,2014,420000,258384,178618,437002,17002,0.038906,0.040480952,4/25/14,6.9,736,"['Crime', 'Thriller']"
Blue Ruin,2014,420000,258384,178618,437002,17002,0.038906,0.040480952,4/25/14,6.9,736,"['Crime', 'Thriller']"
I Want Your Money,2010,400000,433588,0,433588,33588,0.077465244,0.08397,7/6/10,4.2,5,['Documentary']
Rotor DR1,2015,350000,0,0,0,-350000,#NAME?,-1,10/20/15,4.3,4,"['Science Fiction', 'Family']"
Locker 13,2014,300000,3496,0,3496,-296504,-84.81235698,-0.988346667,3/29/14,6.4,4,"['Horror', 'Drama', 'Thriller']"
The Looking Glass,2015,300000,1711,0,1711,-298289,-174.3360608,-0.994296667,10/23/15,6.5,2,[None]
Some Guy Who Kills People,2012,300000,0,0,0,-300000,#NAME?,-1,10/5/12,6.1,59,"['Comedy', 'Horror', 'Thriller']"
Teeth and Blood,2015,300000,0,0,0,-300000,#NAME?,-1,3/10/15,3,1,"['Horror', 'Action']"
Anderson's Cross,2010,300000,0,0,0,-300000,#NAME?,-1,5/20/10,5,1,"['Romance', 'Comedy', 'Drama']"
Compliance,2012,270000,319285,511415,830700,560700,0.6749729144095341,2.0766666666666667,8/24/12,6.4,340,"['Drama', 'Thriller', 'Crime', 'Mystery']"
Sleight,2017,250000,3930990,3460,3934450,3684450,0.9364587172285834,14.7378,4/28/17,5.3,367,"['Drama', 'Thriller', 'Action', 'Science Fiction']"
Sleight,2017,250000,3930990,3460,3934450,3684450,0.9364587172285834,14.7378,4/28/17,5.3,367,"['Drama', 'Thriller', 'Action', 'Science Fiction']"
Like Crazy,2011,250000,3395391,333009,3728400,3478400,0.9329471086793263,13.9136,10/28/11,6.5,638,"['Drama', 'Romance']"
The Canyons,2013,250000,59671,2704,62375,-187625,-3.008016032,-0.7505,7/29/13,4.3,134,"['Thriller', 'Drama']"
Test,2014,250000,18823,0,18823,-231177,-12.28162355,-0.924708,9/27/14,8,1,"['Drama', 'Science Fiction']"
Rust,2010,250000,0,0,0,-250000,#NAME?,-1,10/7/10,8,1,['Drama']
The Christmas Bunny,2010,250000,0,0,0,-250000,#NAME?,-1,11/28/10,6.1,11,"['Drama', 'Family', 'TV Movie']"
The Frozen,2012,250000,0,0,0,-250000,#NAME?,-1,10/10/12,4.2,20,"['Horror', 'Thriller']"
Butterfly,2010,250000,0,0,0,-250000,#NAME?,-1,10/31/10,5.5,2,"['Thriller', 'Horror']"
Rock the House,2011,250000,0,0,0,-250000,#NAME?,-1,6/18/11,5,4,"['Family', 'Comedy', 'Drama']"
Burn,2012,225000,1109276,0,1109276,884276,0.7971649977102182,3.9301155555555556,11/1/12,7.1,14,['Documentary']
The Grace Card,2011,200000,2430735,0,2430735,2230735,0.9177203603025422,11.153675,2/25/11,6.5,18,['Drama']
The Overnight,2015,200000,1109808,56188,1165996,965996,0.8284728249496568,4.82998,6/19/15,6,200,"['Mystery', 'Comedy']"
Middle of Nowhere,2012,200000,236806,0,236806,36806,0.15542680506406087,0.18403,1/20/12,6.5,11,['Drama']
H.,2014,200000,0,0,0,-200000,#NAME?,-1,9/7/14,6.3,8,"['Thriller', 'Drama', 'Science Fiction']"
Weekend,2011,190000,484592,1092993,1577585,1387585,0.8795627493922673,7.303078947368421,9/22/11,7.5,287,"['Drama', 'Romance']"
Arrowhead,2017,180000,0,0,0,-180000,#NAME?,-1,6/23/17,4.9,58,"['Action', 'Adventure', 'Mystery', 'Science Fiction']"
Arrowhead,2017,180000,0,0,0,-180000,#NAME?,-1,6/23/17,4.9,58,"['Action', 'Adventure', 'Mystery', 'Science Fiction']"
Another Earth,2011,175000,1321194,781585,2102779,1927779,0.9167767987030496,11.01588,7/22/11,6.7,853,"['Drama', 'Science Fiction']"
Sparrows Dance,2013,175000,2602,0,2602,-172398,-66.25595696,-0.985131429,8/23/13,7.4,6,"['Drama', 'Comedy', 'Romance']"
Sparrows Dance,2013,175000,2602,0,2602,-172398,-66.25595696,-0.985131429,8/23/13,7.4,6,"['Drama', 'Comedy', 'Romance']"
The Fits,2016,170000,166425,2817,169242,-758,-0.004478794,-0.004458824,1/22/16,6.6,66,['Drama']
Speak No Evil,2013,150000,0,32927,32927,-117073,-3.555531934,-0.780486667,5/24/13,3.6,19,['Horror']
Aroused,2013,150000,0,0,0,-150000,#NAME?,-1,2/20/13,6.6,18,['Documentary']
Your Sister's Sister,2012,120000,1597486,1493107,3090593,2970593,0.9611724999053579,24.754941666666667,6/14/12,6.6,192,"['Drama', 'Comedy']"
The Gallows,2015,100000,22764410,18892064,41656474,41556474,0.9975994127587468,415.56474,7/10/15,4.8,591,"['Horror', 'Thriller']"
A Ghost Story,2017,100000,1594798,1174984,2769782,2669782,0.963896076,26.69782,7/7/17,7,906,"['Drama', 'Fantasy', 'Romance']"
Indie Game: The Movie,2012,100000,0,0,0,-100000,#NAME?,-1,5/18/12,7.8,259,['Documentary']
The Night Visitor,2015,100000,0,0,0,-100000,#NAME?,-1,11/22/15,4.5,2,['Horror']
Queen Crab,2015,75000,0,0,0,-75000,#NAME?,-1,9/29/15,3.2,5,"['Science Fiction', 'Horror']"
Happy Christmas,2014,70000,30312,0,30312,-39688,-1.309316442,-0.566971429,6/26/14,5.1,95,"['Comedy', 'Drama']"
Absentia,2011,70000,0,8555,8555,-61445,-7.182349503,-0.877785714,3/3/11,5.9,175,"['Mystery', 'Horror', 'Thriller']"
Hayride,2012,60000,0,0,0,-60000,#NAME?,-1,10/13/12,4.6,10,"['Thriller', 'Horror']"
The Dirties,2013,55000,0,0,0,-55000,#NAME?,-1,10/4/13,6.1,57,"['Drama', 'Crime']"
Tiny Furniture,2010,50000,391674,32475,424149,374149,0.8821168975996643,7.48298,11/12/10,5.9,82,"['Romance', 'Comedy', 'Drama']"
Counting,2015,50000,8374,0,8374,-41626,-4.970862193,-0.83252,7/31/15,8.3,3,['Documentary']
Down and Dangerous,2014,50000,0,0,0,-50000,#NAME?,-1,2/14/14,4.3,9,"['Crime', 'Thriller', 'Drama']"
"Run, Hide, Die",2015,50000,0,0,0,-50000,#NAME?,-1,9/1/15,3.5,2,"['Thriller', 'Horror']"
A True Story,2013,45000,0,0,0,-45000,#NAME?,-1,9/20/13,6.6,4,['Comedy']
This Is Martin Bonner,2013,42000,0,0,0,-42000,#NAME?,-1,6/28/13,5.7,9,['Drama']
Raymond Did It,2011,40000,3632,0,3632,-36368,-10.01321586,-0.9092,3/27/11,3.7,8,['Horror']
Foreign Letters,2012,40000,0,0,0,-40000,#NAME?,-1,4/22/12,5.3,3,[None]
Her Cry: La Llorona Investigation,2013,35000,0,0,0,-35000,#NAME?,-1,4/19/13,5,2,['Horror']
Krisha,2016,30000,144822,0,144822,114822,0.7928491527530348,3.8274,3/18/16,6.8,86,['Drama']
Krisha,2016,30000,144822,0,144822,114822,0.7928491527530348,3.8274,3/18/16,6.8,86,['Drama']
Exeter,2015,25000,0,489792,489792,464792,0.9489579249967333,18.59168,3/26/15,4.7,121,"['Thriller', 'Horror']"
All Superheroes Must Die,2013,20000,0,0,0,-20000,#NAME?,-1,1/4/13,3.9,19,"['Science Fiction', 'Thriller']"